15 15 0
3 6
8 14
##.#....##..#.#
.#......#.###.#
#....###.#..##.
##..#.......#.#
.#....##....#..
..###.........#
...#.#..##....#
##.#...###.....
###.#..#.#.#.#.
.##...###.###..
.##.#.##....#.#
..###.###..#.##
#...##..###.#.#
#..#.#....##..#
..##.#######..#