15 15 0
1 10
10 8
.#..#..###.##.#
.#..#......#..#
#.....#.##.#.##
###..##.#..####
#.............#
....#.#.##..#..
.#...#....#.#.#
...#..###.#....
##..#.##....#..
.#..#...###....
.##..#.#.#.#...
#..............
#.####..#.#..##
#..#..##...#.#.
#.###...##.....