15 15 0
13 4
10 9
##....#.#..#...
.....#...#.#...
#.####.##.###.#
.....#.##.....#
#.#.#..##..##..
#...#.#..#..#..
..####.#..#.#..
#.####.....###.
.#..#..###....#
..#.##.##....##
...........#...
##..###.#..##..
##...#..#..##.#
..#....########
..##.#.#.....#.