15 15 0
6 5
10 3
#.##.#........#
....#.#..#.#.#.
..##.##.#.###..
.#...#.###.#.##
...##..##....#.
.###..#...####.
.#.##.#.#.#...#
#..#..#.#.####.
..#....#...#.##
###...###....##
#.#..#.#.###.##
#.#.####.###.##
.###...#.##.##.
.#...#..###.##.
##..#..###..#.#