15 15 0
5 7
6 7
....#.####...##
....#####..#...
.#####.#.##.###
.##..#.#####.#.
.#...#.#.#.....
..####..###..#.
#####.#.#.##.##
##.#.#..#.#####
###..#.#####..#
####.###.#.##..
.########.###..
#.###.###.#.###
.#.#####.#####.
.#..#.###.###..
#...#.#.#.###..