15 15 0
14 1
14 7
..###........##
.###.#..##..#.#
####.....#..#.#
###.##.##......
.###.##.###..##
..##...#..#..##
......##.#.#..#
.##..#..######.
###..##......##
.###.###.###...
.#.###.##....#.
..#.#...#....##
##..#..##.##...
##.......##.##.
....#.#......##