15 15 0
5 5
7 5
#.##.#..##.#..#
###...#.#..##.#
....#..##.....#
#...###..#....#
##..#..#......#
.##...##.#..#.#
........##.#...
.##...#......#.
#...........#.#
.#..#.##...###.
.##..#.#..#....
...#..######.#.
######..#.#.##.
##.......###...
#.##.#.###.....