15 15 0
4 9
7 5
..##.#.....#.#.
.#........#.#..
....#........#.
...###.#..#....
..#.#.##...#.#.
.....#..#..#..#
#.#..##..####.#
...#..#...#..#.
..###.#####..#.
......######.#.
#.#.#..#..##..#
......##......#
...#.##.....#..
...#......#....
.....#.##.#.#..