15 15 0
0 1
3 2
.....#..#.#..##
...#####.#....#
#..###.#.#.#...
.#.....####.#.#
...#...#...###.
#.#.##...##....
.##....#...#.##
#..##.####.#.#.
##.##..#...####
#.#..#...#.#..#
.#.###.##....#.
#.#.#....####.#
..#..#..#...###
..#.#####.#....
.###.#.#####.##