15 15 0
7 14
6 9
#....#..#......
..#####.#..##..
....####....###
#.#..#.##....##
.#...###..#.#..
..#####..####..
.#..#..........
##...#....#....
#...####.#.####
....#.###..##..
#...##..#.#.#..
#....##.#.#.#..
.###...#..#.##.
.#...##.#.##...
...##...#......