15 15 0
2 3
3 10
##.....##.#....
#...#.#...#..##
##..###.....##.
#..........#.#.
..######....#.#
...##..##..#.#.
.#...........#.
.###.#.#.#.....
#.#####........
..#.#..####.#.#
.....#..##.####
.#.#.###.#.#...
#....##..##..#.
.#....#..#....#
.#...#..##.#..#