15 15 0
3 6
7 10
.#...##.##.##..
###....#.#.#.#.
##.#.###.###..#
.#...#...##.###
#........######
####.....#...#.
#.#.###...##...
####.#.......##
#.#.###.###...#
###...#..#.#.##
..##..#.....#..
#..#...###..#.#
#.#..#.##..##.#
.########.##.##
..#.##.#.#.##..