15 15 0
12 4
6 7
###..###..#.#.#
.##.#.....#.#.#
....#####.##..#
..#.#..........
.#.....#.##..##
......##.#....#
.#.##...#..#...
##...##...#....
#..#..#.##.....
#####....###.#.
..#..#.#.####.#
##.#...#.###..#
.....##.##.#.##
.###..###.....#
..#.#.#.#..####