15 15 0
11 5
9 6
..#.#....##...#
###.####...###.
##....#.##...#.
.#....###.....#
.....#..##.##.#
###..#.#.....#.
##.............
#.#...#...#..##
..#..#....#.#.#
........#......
......#..##....
..##.....#..###
...#.#....#.#..
#.#.......###..
.#.#.##.#.##..#