15 15 0
2 8
6 10
###.#..##...##.
....###..######
..#.##........#
###.#..#.#..##.
.....#..##.#...
.##...#..#..#..
##.##.##.....##
#.....#....##..
#.......#.##.#.
#.###.#.##..#..
#.#.#..#......#
#.#..#.#....#..
#.####.####.#..
....#..#..##..#
#.##.#.##...###