15 15 0
3 6
3 12
....##.#####.#.
#..#...####.#..
..#....#..#.#..
.##.....#.#..#.
..##.##........
###...##....#..
.#....#.#......
..#..##..#..#..
#####....#..#.#
.##.####...#..#
.#.###...###.#.
.#..#.##...#..#
###.##.###....#
#...#..#..#..#.
....##..###.##.