15 15 0
8 7
10 2
..#.#.#.##...#.
#....#......#..
......#.###.#.#
..##..#.##.#...
#.#....######..
.###.#....#.###
.###.......#.##
###.....###.#.#
#..........#...
..........#.##.
#...##..##.#.##
##..####.###.##
.#.##....##.#..
..#..#....##.#.
.##.#.#.####..#