15 15 0
7 3
8 1
....#.##.#.##..
#.....#.#.#..#.
.....#.#...#...
....#.#..##.#..
#.##.......#.#.
##.....#.###..#
###..#.###.####
.##.####...#..#
#....#.##..####
..####....##...
...#.##....#.#.
......#.#..##..
..###.####..###
.##.##.#.#..##.
.##.....##.....