15 15 0
3 2
4 0
...##.#........
.#..#.#.###.##.
.#...#...###.#.
#..####.#......
...#...#..#.#..
#.......#.##...
#....##.##.#...
#...##.####.##.
.#.##.#..##...#
.#..#.#.###.#..
##...#.#..#.###
...####...####.
#.##...#...#.##
#..#...##..####
.###.##....#...