15 15 0
6 7
2 11
###.####.#####.
....###..#...##
.#...#.####.##.
#.#.##.####..##
.#....####....#
#.#........#..#
.##...#..##...#
##.#.#.#.#...#.
.#....#.....#.#
..##.......#...
##..#......#.#.
......#....#...
#..#...##...##.
..#.#........#.
#.#..##...#.#.#