15 15 0
10 3
7 7
.....#..#.##..#
....#....##.#..
....###.#......
..#..#.######.#
..#.....#.#....
....##..###..#.
#..##..###..#..
.####...#...###
#.....##..#.##.
.....##.#..##.#
#.#..#....##..#
....###.#..#..#
####...##..#.#.
..#.###.#..#.##
.###...##.##...