15 15 0
5 5
4 7
.###.##...##.##
.#.#####.#...##
##.#..####.###.
######...####.#
##.###..##.##..
.#..#..#.######
#....#.#######.
.##.##..#...#.#
######.######..
###.#...#######
.#.#.####..#.#.
.######.###.##.
.##.#.#.#####.#
#..#######...#.
..####.##.....#