15 15 0
7 4
9 10
.....#..#..##.#
##.#.#.#.#..##.
...###.#..#..#.
.......#.##...#
#...##.#.#....#
.....###....#..
#.#.#......####
.......#.#.####
..#.###.....#..
.##.#..##..#.##
....#..#....#..
..##.####..#.#.
.#....#.##..#..
#..#.#.#..##.#.
##...#..#..##..