15 15 0
9 0
7 5
..##.#.#..#...#
#.#.##..#.#.#..
...####.##.####
#...##.###.####
#.#.##....#....
##.###..##.#.#.
...........####
.##...####..##.
#....#####.##..
..#.#..#.#.#.#.
.#..#.#########
...#..#.#.#.#..
......##..#.#.#
....#...##.....
.#.#..#...#....