15 15 0
6 6
3 12
#.#.....#.#.###
##.#.....#....#
..#..###....#.#
.####.....#...#
..###..#.##...#
.....###.##..##
##..##....##.##
#..##...##....#
.....#.......#.
.....##.#....#.
#.#....#..#.##.
##.##.#...####.
.#..#..#.#..##.
.......#.#.##.#
#..####.####...