15 15 0
1 7
0 8
.###..#..#..###
#######.##.#..#
...#.#.#..##...
.#.#..####..#..
..###..###..#..
####...##.#..#.
..#.##.#####.##
####.#.##..####
.#.#####.##.###
#.##..#####.###
###....#.....##
##.##..#..#####
.###.####.#####
#.##.###.####.#
.#.##....###..#