15 15 0
6 1
13 7
.##.#..##.#...#
.#.##........##
....#.......###
#.#....###.##..
...#.##...##.##
.#.##.#.##.#.##
...#......#..##
...#...##......
##.......#####.
.#..##.##.#...#
.##....#..#.#..
..#.##....####.
..#......##...#
.#..###..##...#
....#....##.#..