15 15 0
11 5
12 6
###...#.###.###
..###.##.##.#.#
..####..###.###
..#.####.##.###
.#####.###...#.
...##.###.#...#
#...##.##..#..#
#.#....##.##..#
.#.#.###...#...
#..#.#.#.#.##.#
####.#..#..####
.###..#########
##..#..#..#####
#....##########
..#.##.##.#####