15 15 0
5 8
4 3
##....##.#.##..
.####........##
.####..#.##.###
#..###.#.###.#.
....#..#...#..#
..#.#.#....##.#
......##.#.#.##
###.#......#..#
#..##..##..#...
#.###.#.....###
.###....#...##.
#...#.#.##.#...
#...#.#.....#.#
...##....##.##.
...###..##.####