15 15 0
9 12
12 1
.....####.##...
#...#..#.#..##.
#..##.##.#.#.#.
.##.#...#......
...#.#...#..#.#
#..#.#...###..#
.#.##.......###
#.....#.###..#.
#.#....#####...
..###...#.##.##
#.#.######...#.
#.##.#..##...##
#..#.###.##.###
....##.##.#.#..
....##.###..#..