15 15 0
4 11
8 5
..###..#######.
...#...#....#..
##..##.#####...
#.####...##...#
.##.........#.#
###.......####.
..#..#...#...##
#..##.....#....
........##..#.#
.##....##......
#.#.#..##.#....
.....#.#...#.#.
..#######.#..#.
#.##..#...#..##
.#.##..........