15 15 0
12 3
6 8
..#...#.......#
.#...#...##.#.#
.#.....##..#.#.
..####..#.##...
...##....#..#.#
#..#.......#.#.
###...#........
..#....#.....##
..##...#....###
.....######....
#.#.#.#..#...#.
..####.###.##.#
....#.##.#.#..#
.......#..#...#
...##..#.#.##..