15 15 0
6 12
1 6
.#..#...#..#..#
#..#...##......
....##..#.#...#
.#.#.##....#...
##.###.###.#.##
.##....##.##.#.
..###.##..#..##
..###.###.....#
##......####..#
.#.###.#..###..
####.###.##...#
..##..##.#..###
.#.#.#..###.##.
.#....##.##.###
#.....####.##.#