15 15 0
12 6
12 8
####.##..#.####
#..#.#####.#.#.
##...##.#..#...
#.##...######..
#.###.....###.#
.#...###......#
#.######..##.#.
.##..####.#.##.
..###...#####.#
#.#####.##.####
#..##..##....##
..#.#.##.####.#
###..#...##.#.#
..##..#.##.#..#
...#...#####.##