15 15 0
6 5
12 4
#.......#..#.#.
....##...###.##
....###....##..
#.#.#.#.#..##..
....#.#...#...#
#...........#.#
..##...#.######
#.##...#.#....#
##.#.#.##...#.#
#.##....###.#.#
.#..#.#..#....#
..#.##..#.##...
#.#..#....###.#
..##.....#...##
.#..####.#..###