15 15 0
13 4
14 7
.#..#......##.#
##.##..#....##.
...#...#....#..
...#....#...###
####.....##..#.
..#..#....#....
#....#..##....#
..#....##..####
..#..#....#...#
.###.....##.#..
#....#..###.##.
...#.#...##.#.#
.#..##.#.#.#.#.
#........###...
##....#.##.###.