15 15 0
4 6
3 4
##.###.##.##.#.
#.#.#..#...#.#.
#.###.#.##.#.##
##...#..#####.#
#.##.....##.#..
.#.###...#.#..#
..#..#...#.#..#
##..####...#..#
#.#.#.##...#..#
#.#.##....#....
...#######.....
#.#.###.#...##.
#.###.####..###
##.#.#..####..#
....###########