15 15 0
8 6
1 2
###..###.##.###
##..###.#..###.
#.....#...#.##.
##.#.#..#..#.##
#.##..##.....##
###..#.#..#..#.
###....##......
....#.#......#.
....#..........
.#...#....#.#.#
#.#.##....#.#..
##...#.....#..#
..#..###.....##
##..#.#...#..#.
#....##..#....#