15 15 0
8 0
6 3
###.###.##.###.
#.#######..#.##
#.#..#.##.####.
.##.#.#..#...##
.#....###.##.##
..#...##..###.#
.#...##..##.###
.#.#.#####....#
...#..#..#####.
.#..##...####.#
..#..#.#...####
.###.####..##.#
.########.####.
###.....###..##
..####.#.#...##