15 15 0
9 8
4 12
#..###.....#..#
.##...#..###..#
#..##...####...
..####.###...##
...#..###..#...
#.##...........
..#.#.#.###.#..
.##.##.#...#..#
##...###.#...#.
###...#...#..##
#........####.#
####.##.##...##
...####..#..#..
.....#..#.##..#
##.#..##..#..##