15 15 0
5 1
1 5
....#.###..####
..#....######.#
.#.##.####.....
..##########...
#.#....#...#.#.
#.#..####..#.#.
.###.#.#.......
.##.#.#.###.##.
..#.##.###.#...
......#..###..#
.###.#.....#.#.
...##.###....##
.##.#.........#
.#.#...##......
.##...#...##.##