15 15 0
13 2
1 6
..##...#.#.#...
.#..##...#.#..#
##..##..#.#....
.##.##.....#.##
.....#.#.##.#..
...#.#.#.######
..##.#.##.####.
#.##........#..
#....#....####.
.....#...#####.
.##.##....#...#
.#.##..#..#..#.
..#.##...###..#
#...##.#.#.#...
..##.##....###.