15 15 0
13 0
11 2
#...#.##.####..
###...#.###.#..
#####.#.#####.#
.#....##.###.##
.###.##.##..#.#
...#..#..####.#
###..####.###.#
##.#####..##.##
#..#..###.#..##
#.##.##.##.#.#.
####.####.#.#.#
.#..###.#.#..##
#...###.#.....#
..#...##.#.#..#
..###.#......##