15 15 0
4 12
6 0
#..#....#..#...
.#...#..#...#..
#.#.##....##..#
.#.....##.####.
.#..#...#..#..#
.....###...##.#
.#.#..#....#...
........#.....#
.#..#.#.#.#....
....#.#.......#
###.###.#.#..##
...#.#.##....##
..#.#####......
.#.#.##.###.#.#
#.#.#....#..#..