15 15 0
12 9
6 7
.#####..#...#..
.......#.##..##
.....##...#.#.#
.######.##..###
###.###...#..#.
#...#.#..#...#.
#.#####........
.#.##.##..#....
.#...#......##.
###..#..#......
#.#....#..#..##
..##..#..#..###
..##..#...#...#
##.#..#..#.....
##...#.#.##...#