15 15 0
8 13
2 3
.#...####..#..#
#...#..##..#...
###..#####.###.
.#.........#...
...#.#..##..##.
..#..#......#..
..#.#.####.#.##
.##.##.###.....
.##......##.#.#
#.#.....#.#.#..
.#...##.....###
.##...#.....#..
##..#..#...##..
...#...##.#..#.
#....#...#.####