15 15 0
7 3
6 2
#.###.#..###.#.
##.#....##..#..
..##..###...#..
......#.#..#.#.
##.#..##..#.#..
#.#...###.#####
##.......#.###.
##....#####..#.
.....###...#...
.#.#.###.####.#
....#....##.###
#.#.##.#####..#
...#..##......#
#..####..##.###
###.#..###...##