15 15 0
3 8
5 11
.##...###.###..
..##.##.#####..
.##...#.####...
#.#.#.#...##..#
#..#####.....#.
..#.##.#.##.#..
..#.####.......
#..####........
.##..###.#.##.#
#.#.#.##..#....
.#..##....#.#..
.#..##.#.#.#...
##...##..#..##.
##.###..#####..
##...#####.##.#