15 15 0
8 3
5 3
#..#####.##.#..
..######...#.#.
..####.#.##..##
..####...###.#.
#.##.###...#.#.
###..##.#.###..
#.#.#####.#...#
..#.#.#.####.##
#.#...#....#..#
..#.#.####..#.#
##.##.###....#.
##.####...####.
#....##...#####
###...#.##.#.#.
.#.#######..##.