15 15 0
12 9
13 10
#.#..##.#...##.
.#####...###..#
##..######.##.#
##..#..##.####.
##....#.##.#.##
#..###..#.#####
..#...##..##..#
####..##..###..
..##..#.#.#...#
#.##.##.##.####
..##.#########.
.#..###..#.#...
#.#..##...#...#
###..#.##..#..#
###.######.#..#