15 15 0
6 11
6 12
##....#.....###
.##...#.#.###.#
..#..###.##..##
...##......##..
..###...##..##.
..#...#...##...
...#...##.#....
###..#...##....
.#.###..#.....#
.....##.....##.
##.###.##...##.
..#..#.#...##..
#####.###....##
###..#...#..#.#
#.#.#.....#.#..