15 15 0
10 6
13 0
.#..#..##.###.#
####.##......##
..#.#..##...#.#
.#.#....#.##...
####.##........
#....##.#.#.#.#
.####.##.....##
.##..#.#..##...
.#...#...#...##
........#...##.
#......##.##.#.
#.#...#..#....#
#.#.##..#..###.
........##.##.#
....#.#....##..