15 15 0
11 5
6 14
#....#..##..#..
#.........#.###
###.###.#######
.#.....#.######
##...#.#..#.#..
#..#.#...##.###
##.#.##.#.##...
.#..#..#####...
##.##.....##.##
####.#.##....#.
#.##...###.####
##..#.##..###..
#.####..##..##.
#####.#..###.#.
##..#######.#..