15 15 0
7 5
9 6
.....##.#.###.#
.##.##.##..###.
##....##..#.###
..#..#....#..#.
#..##.#...#.###
...#..#######.#
########.#..#..
#####.....##.#.
.....#..###.#.#
#..#...###..##.
.#..#...####...
#..#...###...##
##.##.#..###...
.##..##..#.#.#.
.##.##.#.##..##