15 15 0
8 12
5 6
.#...####.#..#.
##.#####.#.##..
#.#....##.#####
##.....###.#.##
..#...#.#......
.###.#.#.#....#
..###..........
..##...##.###.#
##.......#...##
##.....#.....##
.#####..#.#...#
..####...##...#
....##..####.#.
#..##.#..#.#.#.
##.#.#......###