15 15 0
4 3
4 1
###.#..##...##.
.#.####.....##.
##...#.######.#
#.#####..##.#..
#.#..#.####.#.#
#..#.##.#..###.
##...#..#..#...
##..#.##.#.##..
#.#..###...#...
##.#.###..#####
.####.#..####.#
.#...#....#....
######...#..###
##.#.##....###.
....#.#.#..####