15 15 0
6 8
8 7
###..#....#....
.##..#..#####.#
....#..#.##...#
##..##..#...#.#
....###..#..#.#
.#.#.#.#.#..#..
###..##..#.###.
..###..#.#.....
.....##..##...#
...#.#..##.#..#
......##..##...
...#..#..##...#
#........#..#.#
##......#..##.#
.##.#...#..##..