15 15 0
8 8
9 0
##.#.##.##.####
##########.....
..#.#..#..#....
..#.###.##.###.
##..##..#.##...
.###.##########
..#.......##.#.
.###..#.#.##.#.
.##..###..#####
..#...###.#..#.
#.#.###..#.####
....#.##.###.#.
##.#..####.##.#
.###..####.#..#
##.#.####.#.#.#