15 15 0
2 14
14 7
..##....##....#
.##.........#.#
....#......##..
##.#....##...#.
...#..#.#..##..
..#...##.#...##
#.....#.#.#.##.
#...#.##..##..#
#......#.#.##.#
.#.#.#...#.#...
#....##.#..##.#
##..#.....##..#
......##.#..#.#
........#.#.###
#.......#######