15 15 0
1 3
9 3
#...##.##.#..#.
###.#.#.##.###.
##..#..#.###.#.
##..#####..##.#
..#...#.##.#...
..#.......#..#.
#.....##.#.....
.#...#...##....
###.......#...#
##..##.##...###
#..#.#...###.#.
#...#..#.......
.#..##..#.#....
#..##....#....#
#.##.....##..#.