10 10 0
3 8
3 7
....##.#.#
#.......#.
##.#..##.#
..#.......
...####...
#.#...###.
.#..###..#
.##..###..
##..##.##.
.#..#.####
