15 15 0
6 1
0 2
....#..##..##..
#..#....#.##..#
..#.##.....#...
#.#.###...#....
#.#.#......#.##
....###.#.###.#
..#...#....#..#
.#....#.##..#..
##....##.##.#..
#.....#...#..##
###..#.#.##..##
.....#...#.#.#.
.###.#.###..##.
#...##...####..
##.##...#.#...#