15 15 0
12 7
12 4
#.#.#..#..#.###
#..#...#......#
#..#....#..##..
###..#..###.#..
..#.#.......#..
#...##......#.#
.#...#..###.##.
...##...#.#....
#.#...#...##...
.#.#.#.....###.
#.#..##......#.
.#....#.##..#..
###......#..#..
.##.####......#
..##..###.##.##