15 15 0
10 13
12 9
...###...#.#.##
..###.#..#.#..#
.#..#...##.....
#..###.....##..
.....#.##....##
..##.##.....#..
.#.#.#....#..#.
.##..###.###..#
##...#.#.#.#...
#.###.#.#.#.#..
#....##..#.....
.###.#..##.##..
.....####..#...
.#........#....
#..###...###.#.