15 15 0
6 7
9 5
..#...#....###.
.#...##.#.#####
.##..........#.
#.#.....#.#..##
.#####..##.#...
...#.#..###....
...#....#.#....
#...##.#.......
.....##.....#..
.#....#..###.#.
..##..#..#.#.#.
#..#..#.#.###..
..#.#....##....
.#..#..#......#
##..#.#....#.#.