15 15 0
10 7
11 4
.########..#...
#....#.#..##...
.##..####......
.....######..#.
..#..#..###.###
..#.#........#.
##......#.....#
##.#.#######.##
.....#..#....##
.##....####....
#.##.##....#..#
.#.#..##..#...#
##.##.......#..
.#....#.#####..
.#..##..#.##...