15 15 0
3 8
3 2
..##.#.#.......
##.#.##...#..#.
...#...#......#
#.....#..##...#
#..#..#.#...#..
.#.##......#...
#...#...#...##.
...#.###...#...
....#....##...#
#.......##....#
#.##..####....#
#.#...#.....#..
....###.##.#...
......##...#...
...##..##....##