15 15 0
13 5
11 10
...#.###..#####
#..####..####..
#...###.#.####.
#######..#####.
#..#....#.....#
....#.#.##.#.#.
...#..#..##....
#.#.##.#....##.
.#...#.#.##.###
.##.#.#...#..##
....##.#....#.#
..##....##.....
##.####....###.
.####....#.#...
.###...###.#..#