15 15 0
5 12
9 7
.##..#.###..#.#
..####.....#..#
.#.#.#.##..###.
.....##..#..#..
#...##.###...##
#.##..##.#.#.#.
...#.###...#...
..#.......#.#..
##.##..##......
.#..........##.
##.#.#..#.#####
###......#.....
...###.###...##
...##......#...
#..###.##.#.#.#