15 15 0
1 7
3 10
#..####.#####.#
#..#..#....#.#.
#..#.#....##...
.###.......##..
#.#..#.#.#.###.
...#....#..#.#.
...####.#....#.
.#######.######
#....##.####.#.
..##.#..#......
.###...#.....##
.#####...#.....
...#.##...#...#
...#.#.#..#....
#######...####.