15 15 0
11 1
14 10
##.##.###.####.
.#.#..#..##....
.#.....#..#....
.##...##.#.#.#.
...##..##...##.
..#....#.......
..#.#..#..###.#
.#..######.#..#
..########..#..
##......##..#.#
#.....####.###.
...#.###...#.##
..##......###..
...#....#..###.
.#..###..#.#...