15 15 0
2 2
4 7
##.##.##..###..
#.............#
.#.##.#..###...
##.#..##...#...
.##.....####.#.
.#######.#.#...
#..##.#.....###
.##.###...##...
#...#....#.####
...####..##.#..
.###...###.#.#.
#.#.#.#....###.
.#..#.#...##...
...#######.#.##
...########.#..