15 15 0
8 3
1 6
.....##.#..#.#.
#.#..#.#.###...
.##......#####.
#.#...#.##..#.#
..#..##.......#
..####.#.#..##.
##.....#.#...##
###.#..#.#...##
..#.#....##.#..
.#.#....#..#...
.###..#..#.#...
.....#....#.##.
.##..##...#....
##.............
...#...#..####.