15 15 0
8 7
14 4
#.#.........#.#
...#....##.#..#
.......###.....
..........##.##
..####..#.#...#
.#.....##.....#
.#...###.##.#.#
##.....#.#.....
.#...#...#..###
##..#......#..#
...#..###.#####
#..##...##..###
.#..#....#.#...
##..#.###.#....
##............#