15 15 0
0 12
4 1
..#..#.#.##....
.........#...##
#......#...#.#.
..........#.###
#.#.#.#...#.#..
....##.#.###...
..##.......#..#
.#.###......#..
..#..##...####.
...###...###..#
.##.....#..#...
.#....#.....###
..#..#..#...#.#
#..#..#.......#
..##.#..#.##.#.