15 15 0
11 4
7 8
...#...###..#..
##.....###..#..
..##..###.#....
..###..#.######
...#.....#.##.#
..#.#..#..#.#..
...#.#.#..####.
##.##......#...
..#......#.####
#..#..###....##
#.###....###..#
.#.#..####.#...
...#..#....#..#
###...##..##..#
.#....##.....#.