15 15 0
1 12
4 10
..#...####...#.
.#######..##.##
##..####..#...#
#.##.##.##..###
#.###.#.....##.
..#.....#..#.##
#......#...##..
#..###....#.###
#.#....#......#
#..#....#..####
##..#.#...#.##.
....###.#.#..#.
.####..###..#..
#.#..#.##...#.#
...#.#..##..#..