15 15 0
10 4
8 9
.#.#...#..#.###
.#..#..#..#....
#.#...##.#####.
#.....##...##.#
.##...###.##.#.
#....#.#.##.#.#
######...#.##..
.#......####.#.
#..#.##...#.#..
#..##.##..#...#
#..#....#....#.
#....#..####...
#.#...#..###...
#.#####.##....#
.#...#.#...#..#