15 15 0
3 10
1 11
..####.#####.##
#.##.##...#.#.#
##.###.##.#..##
.#...#.#.#..#..
.#.##..##.#...#
..##.##..#..#.#
#.#.#.##.###...
#.....##.######
#...###########
###.#.####.#.##
##.#...#..#####
###..###....#..
.#.####.###.##.
.##...#####...#
.###.###..###..