15 15 0
13 4
5 1
###.##...######
#.#.###...#.#.#
#...#..##....##
..#.#..##....##
#...#....##.#.#
#..#..##.#.##..
#..#.###...#...
....##.....#.##
#....##.#..#..#
......#####...#
.........#.##.#
......#..###...
..#...##...#.#.
#...........###
#...#.##.#..##.