15 15 0
13 1
0 7
.##..#........#
.#..#.##.#...##
###.#..........
....#....#...##
..#..#.##..#.#.
#.....##.#.#...
##.#.....##....
.#..#........##
....#..#.#.....
......####..###
####..##.....#.
#.....###....#.
....#.##.......
...#..###.....#
...#.#..#..#..#