15 15 0
9 2
10 8
.###..##..#..#.
#.#.#....#....#
#.#..#.##..#.#.
..#.....#..#...
..###..#....#..
.#..#..#.#.#...
#........##....
.#.##..##......
.......#...#...
##.......######
#.#..##..##....
...##..#....###
....##.###.#.#.
###...###...##.
.#..##.##....#.