15 15 0
4 12
8 11
..#....##.##.#.
##.#..##..###..
.##.####.###..#
###..##...##..#
###.##.#####.#.
####.#####.#.##
...#.##..##..##
#.####..###.##.
####...#.#..#.#
..##.###.#...#.
.#.##.##..#.#..
###..##.##.#.#.
#.#.##########.
#..#####..###..
######.#..#####