15 15 0
2 4
12 6
..#.##..#.#....
#.#...#.#....#.
..#....##..#..#
.#......###.##.
.#....#....#..#
.#.##.#.#.##...
.##...#....#...
.#..#.##...#...
...##.#...#..#.
#......#.....#.
....#.#..##..#.
..#.#.#.##..#.#
##.#.#.###....#
##...#..#..##..
..#..#....#.#..