15 15 0
9 2
6 6
.#.#.........#.
######...##...#
.####.#...####.
##..##..#####.#
.#...###...##..
....##.########
..#.#....#.#..#
#.#...##...##..
.#...#..#....#.
......#.##.#.##
##.###.##..#.#.
##...#..#.##.##
...#....#...#..
###.......#....
##...........#.