15 15 0
5 3
11 4
######.##..####
.#.##..###.....
..####.###...##
####.#......#..
..##..##.###...
.##..#####...##
..##.#.####.#.#
.###...#......#
.#..#..##.....#
.........###.##
#...######.#...
.#...#.##.###.#
...##..#.#.####
#.#......###.##
####.#.###.#..#