15 15 0
9 10
6 7
####..#.#.#....
..#....#.###.#.
.#.#...#...##..
.....####..##.#
...#.........#.
..##....#.#...#
#.#...#...#...#
.#.##.#..#....#
#....#.#.....##
..#..#..##....#
.##..#...##.###
#.#..#.######..
.#.#.##..###..#
#..##.#.#####..
#.#.#......###.