15 15 0
5 12
3 8
.....##.#.....#
..#####.....#..
.##....##.#...#
....##.#..#.##.
#...####..#.##.
....#....#....#
#####.####..###
...##.....#####
#....#.#.#....#
######..#....##
.#...#...#.#.##
#.#.##.#..#..#.
#.##.#....#.##.
...##.......#..
...##..........