15 15 0
4 13
5 13
#.#..#####.####
..#.##.###...#.
#######.##.#.##
##...######..##
..#..######...#
#.##.#.##..#..#
.##.##..###.#.#
#.###.###.#.###
..###..#.######
##...##.#.#####
###.#.###.#.###
.###.#.##.##.##
.###.#..#######
.####.####.##.#
#.#..####.#...#