15 15 0
10 14
6 14
.##.#..##..#..#
###.##.###..#..
....##..##..###
.#...#.#######.
##.##..#.####.#
#..#..#..#.##.#
.######.#.#....
.##..#####.##..
.####.########.
##..##.#...#.#.
#.##..##.####..
....#..#.#.###.
#.#.####..####.
#####..###..###
..###.#.....###