15 15 0
1 7
10 14
#.##.####..#.##
.#..##...##.#..
..###......#.#.
##.#.##..#...#.
....###.##.....
..#...##.##.#..
..#...###....##
##....#.....#..
.#.#...##...##.
.....###.##.##.
.##..#....#....
.#...#....#.###
#..####....#...
...#...#.####..
..##.....#..#.#