15 15 0
0 10
5 12
##.#.#.###..#.#
##.#.##.#...#.#
..##.#.##.....#
#.###.......##.
....##...##..##
##...####.##...
...#....#..###.
#.###....#...##
..#.#.#.##.....
..##.##....#...
#.....#....#.#.
###.##...#.###.
##.##.##.#.....
##..###........
....#.#..###..#