15 15 0
13 4
8 2
.#...#.......##
..##.#......##.
..#.#.#...#.#..
..#.###.#.##..#
#....##....#..#
.##.##########.
#..##.###......
#..####.#.####.
...#.#....#...#
.##....#.#.....
....#.#...#..##
###...##....###
..##.#...#..###
###.....###...#
..##...#.......