10 10 0
0 5
0 3
......#.#.
.##...##..
..###.#..#
###.#.#.##
##...#..#.
#...#.##.#
#....#####
###....#.#
#######.#.
#...####.#
