15 15 0
6 7
14 4
.#...#.#..##...
..##.#..#.###..
#.#..#.#...#.#.
..#..#.###..#..
####.####..#.##
##..###.##....#
...#.##.#..##..
.##.##..#######
##.###.##..##..
###..#......##.
#########.#...#
#.####.#..###..
...#.###.#..###
#..#........###
.##..##...#....