15 15 0
11 6
5 6
.##..#.....###.
##......#..##.#
#####.#.###..#.
...#.##.....#..
......#.#...#.#
#.###..#..###..
#.##...#..##.#.
#.##.#..#.#....
.#.##.#......##
..##.##..#.#.#.
###........###.
.#.#...##.###.#
#.....#....##..
....###.##.#..#
#####..##.####.