15 15 0
2 9
4 13
...#..#..#..#..
.....#..#.#...#
.#..##..#.#....
.##...##.....#.
#...#....#....#
.#...##..#.#...
#.#.#.##...#...
##.##.#.#.#...#
..#.##..#......
#.....#..#...#.
..#..##.....#..
.##.#.#...#....
.#...#..#....##
....#.#.##.#..#
#...#.####...#.