15 15 0
10 14
12 2
.##...#.###..##
..#.#......#...
#.#..####..####
.......#..##.#.
.##...####..##.
#...###.#......
#...##.##.#...#
..##..##.#..#.#
...........#..#
##..#...#......
.#...#.#.......
#.....##..##...
....##..###.###
#.#....##..#..#
.###..#....#.#.