15 15 0
10 12
11 13
#.#..#..#..#..#
.#.##.#...##.#.
###.#..##.####.
.#.....##...###
..#.#.#.#.#..##
.##..#...##.##.
#....###...##.#
....#######.#..
##.##.#######..
...#...#.#.#.#.
#...##..#..#...
##.##......##.#
.##.##.###.#.##
#.##...#.#.###.
#####..##.#.#..