15 15 0
9 11
9 8
.####.#.####.##
############.##
####...####.##.
...#.#..#.#..##
..###.##..##.#.
##.#..##..#.#..
###.##.####.###
####.###.##.##.
##.#...#.......
...####..##...#
####..######.#.
.#.#######...#.
...#.####.##...
#.#..##.#.#...#
.#########.###.