15 15 0
4 13
4 7
....#.#...#####
#.#.##.#..#....
.####........##
.#..#......###.
#..............
..####.#....#..
..#....#.##..##
....#.#...#.#.#
#.......##....#
...#.....#.###.
##..##.#...###.
.#####.###...#.
#.#.#.##.#.##.#
#....#...#.....
###..##.##.....