15 15 0
5 8
1 12
.#.#.#.#..#..#.
.......##.....#
..#..#.#....##.
..##.###.....##
..#..#.#...#.#.
.....###...#..#
...##....##...#
..#.###..#....#
.#.##.##....##.
#.#..##.#.####.
#.#.######.#..#
##.#.#.##.####.
...#.#...#....#
..##...#.#..###
###....##...#..