15 15 0
7 13
7 12
...####..#..##.
####.#..#.##.##
###..######..##
.##.####.#.###.
.####.#.#.#..#.
##.#.###.#.#..#
#####.##.##.#.#
..#.######.#...
.#..##.####..#.
###..#.#.####.#
####.#..#..#.##
..##.##..####..
#####..#...#..#
##.#####.###.##
#...##..####.#.