15 15 0
2 10
4 3
.#.....###.####
.....#.##......
...##..##......
...###.......#.
.#......#..#..#
.#.##..#..#.##.
..##...#..#.#.#
...##.#..#.#.#.
.####.##.##.###
#...#.#...##...
.#....#..##...#
#.##...##.####.
...##.######..#
#..##.#..####..
.#.....#.###.##