15 15 0
14 8
5 11
.#....#....#..#
#.##..#.###....
#..#.........#.
##...#.####.#.#
#####.##.#...##
.............##
#..#######.#.##
.####...#.#..#.
..##.#...###.##
#..........#.#.
....##.##......
.###...#....#.#
.#.#.....##.##.
.....#....#..##
.##.#..........