15 15 0
4 6
5 10
#....#...##.#.#
....#......#..#
...##..#...#.#.
....###.##.#...
###..#.##.#.###
.....#..#...#..
...#........###
..#.#.###..#..#
....#..#..#.#..
#.#..#.#.###...
.#.####...#####
##...#..##.#.#.
##.#.###.####..
.#....#..#.#.##
#..##....#.#..#