15 15 0
14 6
10 10
##..##.####...#
#..##.###.#....
.########.##.##
#.####..#####.#
.#######..###.#
####.#.#####.##
###.###.#..###.
.......##...#.#
.###.######.#..
##....#...###.#
......####.##.#
.##.##...#...##
#####.###..##.#
#..####....####
#####....#..###