15 15 0
4 12
2 1
.#......#.####.
..##...#.#.##..
..##.#.........
#..........####
....##.....#..#
####....##.....
#.###...#.##...
.##.....#......
.#.#..##.##..##
#..##...##..#.#
##.##..#.#.##..
#....###...#.##
#....###.###...
....######..#.#
.....#####..##.