15 15 0
6 4
13 1
##...#.....#.#.
#.##...####.#.#
#.#...##....##.
##..#...#...#.#
#.###.#.#......
#..##.....#....
###...##.#....#
####...##.###..
..###.....#....
#.#.#.......#.#
..#...#######.#
.#.#.###.......
#.##.###....###
......#..##...#
.#.....#..##...