15 15 0
1 2
1 7
.#.#.#...##..#.
#...##..##...#.
###.##....#.#..
..#....#......#
.###.#.##.#..##
..##.#.###...#.
.######.##.#.#.
....###.#..##.#
.#.######.##..#
.#..#..###.#.#.
#.#.####..#..#.
#.#..#.#....###
.....#.####.#.#
...#...#.###.##
.#.......#.##.#