15 15 0
3 0
13 4
#.......#.#.##.
###.###.#.#.#..
..#.......#..#.
..#..##.#...#..
...#...##...#.#
...#.#..####...
#..####.#.#..#.
.....#.#...#.#.
.##..###..##.#.
##...####.#.#.#
..##.#.######.#
.###...##.##...
...#.##.#.###.#
.##.....##.#..#
.#..#.#..##.#..