15 15 0
0 2
1 0
##.##....##.#..
...####...####.
##.##..#.#..##.
##.##.###.###.#
#..######..####
.#.#.##.#..###.
#.###########.#
###.##..##..#..
####.#.#.##..#.
#.##..#.###.#..
##.##.#########
.###.#.....####
.#..##.#.#..#.#
.#######..###.#
.##.##...######