20 20 0
7 16
4 18
#..#####.#.#..#.##.#
.#........#..#......
.#..#...##....##...#
##..#.##...##..#.##.
.#..#...##.##.##....
######...###..##..#.
#.##.###...#..#.....
..##.#.#.#...#...#.#
.#####.#...##.##.#.#
....##.###...#.####.
.##..#.##.#.####...#
##....#.#.#####.##..
..#....#...#..##..##
...#.......###.###.#
.#.##..#.#.#........
#..##..##.##...###..
.##..#.#...##.###.##
.#...#........#..##.
#.##.....#..##.#.##.
#.####.##.....###.#.