15 15 0
11 7
2 13
#.#..#...##...#
..##..#..#.#.#.
..#.##...##.#.#
.#.#.##.###.#..
####.#.#..#.#..
......##..#.#.#
.#.#..#........
#.##.##.......#
....#......####
#...#..##.###..
###......#..##.
#..#..#....###.
..##...#......#
###.#...#.#####
###..##.##...##