15 15 0
5 9
1 12
..#...##..#....
#.#.#.##......#
#...##.##..#..#
#..#.#..##...#.
#......#.#..##.
..###.#....#...
#.#.#.#.####...
#.##...#.#.....
#.#.....#...##.
##....#..##.#.#
#.#.#.#..###.##
##...####..#...
.###...##.##...
.....##..##.#..
.....#..#...#..