15 15 0
8 2
9 5
.#.#.#.##......
.#...##..#.#.#.
..#####...###.#
....###..#..##.
##..#.#.#.##.##
.###..##.###..#
.#...#.#.#.#..#
..##.##..#...##
.#...#..#.#...#
####....#.##..#
.##..#.#.#.#.##
..#...#...#.#.#
#..##.#####.#.#
..#..#.##.##...
..##.###...#.##