15 15 0
10 9
10 4
###...##...###.
###.#.........#
###.#....#..#.#
#..###.#.......
.#.##...#..#...
...#..#.###..#.
.##.#.#.......#
###....#..#...#
#.##.....##....
#.###.#...#.#..
#..#..##......#
..#..#.###.##..
..###..#.#.####
.......#......#
.#...##.#.#.###