15 15 0
12 14
7 9
...#.#...##...#
##...#.#.#..###
###.#.#......#.
##.#.##...#.#..
.##.#.#..###.#.
##.#.#####.##.#
#######..#....#
.##.#..........
.##.###.#.#.#..
#.##....#...##.
.#.##.#....###.
##.#.........#.
.#.#........#..
.#..##...#....#
.....#.##...#.#