15 15 0
10 8
9 4
##.##..##....#.
.#####..###.###
#..###.###.####
#......#.....#.
##.####....#...
...#..##.##.###
.#..#.###..###.
..###.#...####.
###..#..#...##.
.#.#.#..#..#...
.###...#.#..###
#........#..###
..####.###...##
...####.#.###.#
.....##.#######