15 15 0
14 2
5 13
##.##..#....##.
....#.###......
..##.#.....##.#
##.#...#.##..#.
.....#.#.#..###
.#..#.....#....
..#.#........#.
...#....#.#..##
#......##...#.#
.#.....#..#....
......#.#....#.
.##...#.#......
..####..#.#..#.
..#..#..##..##.
....#.#..####..