15 15 0
10 8
12 9
#.#..##.####.#.
.#..##.#.####..
##..##..#######
.##.#..###.#.##
##.###..######.
#...#..#.##.#.#
##.#.....##.#.#
#..#.#.#..####.
....###...#..#.
..#.#.##.#.#.##
...####...#####
###.....#.##.#.
.#.###.....##..
#.#####..##.#..
.##...##...##.#