15 15 0
0 6
7 0
....#...#..#.#.
#.#.....##.....
#.#...#.###..##
#.#....##.##...
#.##..#.#.#..##
...#.#..##.#...
...##..#.##...#
..####..#......
##..##..##.##..
###..##.##....#
.....###.#.#...
##...#.#.#####.
.####..#..##...
.#.#....##.##.#
.#........###.#