15 15 0
4 2
8 3
#..#.###...##..
.#..##.###..###
......#.###.#..
...#.##......#.
....##...#...##
#...#.###..#.##
..##...##.###..
#...##..##.#.#.
#.#..##...#.##.
#..###.....###.
#...#..###.#.##
.##..##...#..#.
####.#..#......
###..###...#.#.
#..#.#....####.