15 15 0
7 9
4 13
#.#########...#
..##.#..#.#.#.#
#.#.##.##..#.#.
######.#..#.###
###...#.###...#
.##.##.#.....#.
######....##...
....##.##..###.
##..##.#.....##
.###..#........
.#.#..#..#####.
#.#...#######..
#.......#.#..#.
####..#######.#
##..#.#..#.#.#.