20 20 0
13 9
12 15
.##..##.#...####.#..
...##########..#....
...#........####.#..
##.##...#####.####.#
.#.#.......###.#.#..
.##.#..##.#......###
.#..######..#..#...#
.##.###.#.#...#####.
...#.#...#...#..##..
#....##.........####
#.#..#..#....###....
..####..###.......#.
..#.##..........#...
.##.#...#...##.....#
.#######.##.####..##
.##.#..####....##..#
###...#...###..#.###
####....#......#.##.
#....##..####.#..#..
#.####.##.#...###..#