15 15 0
13 10
6 1
#.####.##.#.#..
#.##..###......
....#.##...###.
#....#####.#.#.
..#.#.##...#...
##..#.##..#.##.
...#......####.
...####........
#..##.#.##..#..
...##..##.##...
.#...##....##.#
#.....#....###.
#.#....##..#...
####.......#..#
.#.###..##....#