15 15 0
2 8
1 5
.....##.######.
..#........#.#.
#.#...#..#..#..
##.#..#.#.##..#
#....#.........
.......##.##.##
...#.#..##.###.
.#......##....#
.#...####.##..#
...#..######...
...#..##.###.#.
#####...#...##.
#.##...#.#.#.#.
#..#####.......
#..##.....#....