15 15 0
6 7
4 12
..#.###.#.#....
....#.##.#....#
...#..##.##..#.
.##....######.#
...##.#..#.....
.##.#...#....#.
..............#
.#.##.#...##.##
#.##......#.##.
.#.#####...##.#
#.#.#.#...####.
###.##..#.....#
.#.####...####.
...####.####..#
##.##.....#####