15 15 0
5 5
10 7
..###..##..#.#.
.#..#...###....
..#.#.##.##.#.#
####..#...#.###
..##...#......#
.#.#..#.##.#...
...##.#.###...#
#.###....#.....
#...#.#....#.##
.#.#.##.......#
......#..#....#
.##..##........
.....#........#
#.###..##..##..
...#.#.....#..#