15 15 0
3 3
3 13
...#..#....###.
###......###.#.
##.##...#.#.#..
###...#.#.....#
.#.....#...#..#
#.#.##.......#.
..#..#.#.#.....
....#.#.#..#...
...#..##..#..##
##...##........
#.#...##..##.#.
#.#.#.###......
##.#.#...#..###
#.#..##...#.###
...##.###.#...#