15 15 0
3 3
1 8
.....#......#.#
.#.#.....####..
..##...####.#.#
..#.#.#.#.#...#
###.#.#..#.##.#
###.......##.#.
...#..###.#...#
...#.....#.#...
.#.#...#.##....
.#...#..##..#..
..#.##.....#...
..#..##..##.#.#
#.###.#...#.##.
...#.#.#....##.
##.#..#.#......