15 15 0
3 14
2 12
###.#..#.##.###
##.####.#####.#
##.##.#..#.#..#
##.#....#.##...
##.##.######.##
.############.#
######..#..#.##
.###.###.#..###
.######.##.#...
#.###.##.#.#.##
.#######.#.##..
####.####.#.#..
####.##..##.###
###.#.###.#.#.#
...###.#.####..