15 15 0
13 2
9 2
#..#####.####.#
.#.#..#..##...#
..##...#.#....#
..#.#..##..##..
..#..####.#..##
..##...#..#.#..
#..##.##.######
.........#.....
..#.#.#..#..##.
.#..#..#...#.##
....#..#..##...
...#....#......
#####.#...#.#.#
.#......#.#.#.#
..##...##.#.#..