20 20 0
3 17
16 14
.###..#.........#.##
#..#.##...#.#.#.#.#.
.#.....#....###.#.#.
.##..#..#..#........
.#.##.##.#.##...#...
..#.#..#...#..###.##
#.....#......######.
.#..###.#.##.....#.#
#.#..###.##..#.###.#
#......#..##.##.#.##
#.....#.........##..
##..###.#.#..#####.#
##..#..#.#.#..##.#.#
.##.#####.##.#.#####
##.....##......##..#
.#.##.######.....#.#
.##.#..#.....#.#....
..#..####..#.####..#
#..#.......#..#..###
.#.#.#.#...#######.#