15 15 0
4 4
0 9
#..#.##...#.#..
#......##..#.#.
#.##.#.....#.#.
.#.....#.#.#.##
##....###.....#
#...##..#.#....
.#.##........#.
.#.#..........#
..#.#..#.#..#.#
..#..##.#...##.
#......####..#.
.#.#...#..#....
##...#....#..##
.#...#.#.#.##..
##...#..##.....