15 15 0
3 2
3 0
#.#.##....#..#.
#...#.###.#.#..
######..#..#..#
....#.......###
.#....####...#.
....#.......#..
#######.#.#.##.
..#..#...#.#.#.
.#......#..#...
#..##....#..#.#
#..##.#.###.#..
##....##....#.#
.#.#.###..#.##.
..#..###.#..#..
#####....#...##