15 15 0
3 7
11 6
#...##......#..
..#.#..##.#..#.
...#.###.#..#..
..#...#....###.
.....####......
.#####.....##..
.####..#.#....#
.#####.##.#.###
##.#.#.#.##.#..
..#######....#.
#.#.....#.#..##
#.........#..#.
...#..#..##.#..
...##.##..#..#.
#.#..#......#.#