15 15 0
3 7
4 2
..#.#...###....
#####..#..#.#..
.#####.###.#..#
###.##..#.#...#
##...##.###.###
##.#....##.###.
.#..##..#####.#
#..#.##..#.###.
##.##.####.##.#
##.##...#.##.#.
.#.##.###..##..
#.##..#..#.#..#
###..#####..#.#
##.#.#####..##.
##.#####..##...