10 10 0
6 3
6 4
###.#.##.#
#.###.....
...#.##...
.#....###.
....#.#.##
.#.##.....
.#....#.#.
..#...#.#.
.....####.
....#.#.#.
