15 15 0
11 10
5 2
.##.##..#.#..#.
.####...#.#.#..
.##.#..##.##.##
##.....#.#.....
...#..#....#...
.#.......##....
#..##..#.#..#.#
##...#####..#.#
.#....#.#.##..#
##.##.......##.
###..##..#.#.#.
.###..###.....#
.##...###.#....
.#.#......##.##
#.#......#.###.