15 15 0
5 9
3 10
.....#..#.###.#
###.....##...#.
...#.#.###.#..#
####.###.#.#.##
..#.#..###.###.
...###.#....#..
.##.##.##..#..#
.##......##...#
#.#.##......#.#
##.#...#.##.#.#
...#.##.#....##
#.##..#.####...
#..###..######.
...##....##..##
....#.#####..##