20 20 0
8 19
4 12
#.#.#.#....##......#
###..##...#.##.##...
.##..##.......#.....
.##.#...###..#...#..
.#....###.....###.#.
..#..#....##.#.....#
#.#..##.#.####..#.##
.#.....#...###...#.#
##....###.###..##.#.
...#..#...#.......#.
#...###.#......##...
#...#.#..#.#.##.#...
#.##.......#....###.
.....#..#..#.#.#....
###...#.#.#.#.....#.
.###..###...##....#.
#.#.#.###..####...#.
##..##...##.##....#.
..#.##...###.......#
#...#......#....#...