15 15 0
14 9
3 13
#.##..#####....
##.###...#.####
#.#..#.#.###...
.......#.#.....
...###..##..#..
.#...#.....#.#.
##..###.##.##.#
#.#...##.#.####
##....#.##.#.#.
....####.##.#.#
#.#.......#....
#..#.##...#..#.
..#..##......##
#..#..#........
.....#....#.###