15 15 0
8 0
9 2
##..#.####..#.#
.##.#..#.#...#.
.........#.###.
..#.#......#.##
##.#.##.##..##.
..##..#...#.#.#
........###.#..
..#.#####...#..
....#......#.##
......##..#..##
##....##.#..##.
..#..#....#.#.#
.#####.#..##...
#..###.####....
...#..##.....##