15 15 0
5 6
3 12
..###.####...##
####.##.###..##
...#..#..##...#
.####.........#
######.##.#####
.###.#.#.##.##.
#####.#####.##.
.##..#######..#
##..#..###.####
#####..#..####.
###...#.###.#.#
###.#.#.##.#.#.
.##.#..#####.##
##.#.....#####.
###.####..#.###