15 15 0
3 10
4 7
#..#..####.#..#
.##.#.......###
###......#.....
...#..#.#..#...
#..#.##..#..#.#
...##...##.##..
.#..#.#...#..##
##..##..####.#.
.....#...##....
#..#......#.#..
.....#..##.#.##
#.#.......##.#.
...####..#.....
#...#...#.....#
##..###.#......