15 15 0
10 8
6 6
.#.#...#..##.#.
#.##.##.####...
##.#.##......#.
.#...#.#..##..#
..#.#......#..#
.#......#..##..
#..###.#...#.##
###..#..##.####
#.#....#..###..
#....#..###.#..
##.#......#...#
##.##.##.....#.
..#....###..##.
.####..#.#.####
..#.#.##..#.###