15 15 0
9 0
0 3
........##...#.
#..#..##.....#.
.#...#.#...#.##
##...##..###...
..##.....#.###.
.###...#..#..##
.#...#..##.....
#.......####.#.
..#...###.##.#.
.....#....###..
#.....###....##
..##.####.#####
...##...#......
...####.#..#..#
.##....#...#...