15 15 0
8 0
3 2
.###.###.###.##
.###.#.####..#.
##.######..##.#
##...##.###.###
.##...####.####
....#..######..
....#.....#..##
.#.#.#.#...###.
.....###.#..#.#
.#.#..##.#...#.
#####....#.####
..##.....#.....
#.....#####.###
.###...#..###.#
########.###..#