15 15 0
14 4
8 6
....#.....###.#
##.##....#.#.##
..#.####....#..
......#...##...
####...........
#.#.###..##..##
#..#....##..###
#.###.....##...
.##......#.##..
..##...#...##..
#.....#..#..#.#
.#..###.#.....#
..####....####.
.#.#.....#.#...
..#....#.....#.