15 15 0
5 2
11 10
.....#......##.
.#..###.####.#.
#...#.#.#..###.
.##..#..#...#.#
..#...##..#..#.
...##.#..#.##..
...#...##.###.#
.##......#.##..
..#.#.##..#..#.
...#.#.###.#.#.
##..###.....###
.#....##.......
...............
#.#...#....##..
#.##....##...##