15 15 0
1 5
0 14
#..#####...#...
#......##......
#..#.......#..#
#.#.####.#.#.#.
.###..#...#....
#...#.##.#.##.#
#.#.##.#.#...#.
..##..#.#.#.#..
......##....##.
.#.###...##.#..
..#.##.##.###..
...#....#..#...
.##....#.#.###.
.##.####.##.##.
#.#.........#..