15 15 0
12 11
13 12
..#..##.#.#..##
.#...#...###...
....#.....##..#
.###.#.#......#
.#.##.#.#....#.
..##....##...#.
.##.#.#.....#.#
#..##.#####.#..
.#.....#..##.#.
.#...#....##.##
#..#..###...#..
...####..#.###.
#...#....##.#.#
###...###.#...#
.#..#.###.....#