15 15 0
12 6
5 6
..#...........#
...#.####.#..#.
#.#..#####...##
##.####.#..#..#
#...#..#.#..##.
....#..#.#.###.
..#.#.#....##.#
#.###....#..###
..####..#.#....
#...#...#...#.#
#.###..#.#.###.
..#.....#....##
.#.###...##...#
#.#...#..####.#
...#....#.#..#.