15 15 0
7 12
8 14
###...#..#.##..
##......#...##.
#..#...##....#.
..###.#..#....#
#....#.#.#.#...
##.##.###...##.
....#..##.##...
.....#...#....#
.#..#.##....#..
.##.###.#...#..
..#.#.#..#.#...
##.#.#.#....#..
..##.#.#.#....#
.#..##...#...#.
.#..#.#....##..