15 15 0
9 12
13 1
..##.####.####.
##.....####..#.
.#.##.######...
.#...#..##..##.
......##....###
##.##....######
##.#..##...####
......##..#.###
##.##.#.#.#.###
#.#####........
#.###..##..#.#.
#..######.###.#
#....##...#####
#...##.......##
###.......#.###