15 15 0
5 14
9 3
#...##...#.##.#
.#.##...###.###
#...##...#.....
.#.#.#.....#...
.##.#####...###
.##.##.#.##.##.
.###.##..#.....
#...##.#.#.....
..###.#...#..#.
..#.#......#...
#...#.#....#..#
..#.#..#.....##
#.#.#.#..##.###
.#.....#..#...#
.#####...#.##.#