15 15 0
12 5
8 7
##.#......#....
##...#.#..#..#.
.#...#...##.##.
......#....#.#.
..#..####......
...#.......#...
##.#..#..###.##
.#.####....#.#.
#.#...#..##....
...##......#...
....#..........
..#...#.#..#.##
#..##.#.#.#.##.
..#.....##....#
##.##.#.###.#..