15 15 0
7 13
6 6
.##.##....##...
#.#...........#
###.#..##.#.#..
##.#...##......
#.#...#..###..#
.##..##...###.#
....##........#
.###.#...#.#...
#.....#..###...
####..#.#.#..#.
..#.#..##.##...
##..###..##.#.#
..###.....##..#
#.####.#..##...
#.......#.#....