15 15 0
2 3
0 1
#.##.####..#...
......#.....#..
#.#.#..#.######
#.#.....#.#....
#####..######..
.###.#..#.#....
#..#.##..##.##.
#.#...####.#..#
.##.#...###.#..
..#....#....#..
#.....#...##...
....#...##.#...
.##....#####...
...######..#..#
.#.#...#.##...#