15 15 0
13 1
4 2
#..........####
...##.#..#.#..#
.#####...#.#.#.
.##..#.....##.#
#...#####.####.
#......##.###.#
..#.##..#.#....
......#..###.##
#.#####.#..##..
#..#...####..#.
#......#..###..
#.#.###.#.##..#
#.#.#.#.#.###..
#..#.#.......##
#...###....#..#