15 15 0
3 11
0 6
....#......#...
#####....#.###.
#..##.#..##.##.
#.##.#....#.##.
..#..####....#.
.####.####.#..#
##.#...#..#..##
...#..##.#.#..#
.##...#.##..#.#
..#..#.##.##.##
..#..#..###.#.#
#....##....##.#
......#...#.##.
#....#..#......
#.#.##..#...##.