20 20 0
5 18
17 18
....##...##...#.#..#
.#.##..#.##..#.#....
#..#####...#..#..###
#....#.####.##..#...
##..####..#...#.###.
...#......#......#.#
.#...##.##...#..#..#
##.###..#.##..#..#.#
..##..#.#.###....#.#
..###.#....#..#..#.#
#.###.#.#.##..#.#..#
#####..##.#....##.#.
#..##...#.#.....#...
#..#.##.#.##.#..#.##
...###.....###..#.#.
.#.#...##..##.#.#..#
.####.##....###..#..
..#.#..............#
.####...##..#..###.#
#....#....#.#..##.##