15 15 0
12 11
12 6
#...###.###..#.
..#.#..#.#.###.
#.#........#...
.#....##.#..##.
#.#....###.####
##......#.#....
..#.####.#....#
..#.#.#####..#.
#...######...##
..#.#.#..#..##.
##.#..######.#.
.......#.###...
##.......#.....
.##..#..#....##
..##..#...##.##