15 15 0
2 7
5 13
..#..#####..###
.#.#.##........
...#..#.##....#
#..#.#..###...#
.....##...###..
....#.###.#....
.#.###...#.#.#.
....##......#..
..#.......#.#.#
...##...#####..
...#..##..#....
.....##....#..#
.#....####...#.
.........#..#..
......#....###.