15 15 0
0 11
0 13
.##.#.....#.#.#
.###.####.....#
##.#...###.#.#.
#..##.#.##.#.##
.#.#.##.#####.#
##....####..##.
#.#...##.#..###
...######..#..#
#.##.##...#..#.
.###.######.#.#
.##....####...#
..##.###...##.#
...#.##.###.#..
###...##....###
######..#..##.#