15 15 0
10 6
12 5
..#...##....#..
##.#..#..#..#.#
.##..#.#...#.##
#.##..#.#######
##..##...#.....
.##...##...##.#
..#.....##..#.#
...#.##..##.#.#
#####...##.....
#.####...##.###
....##.##..#...
.....#......#..
.###...#.#.#...
..........###..
...#######.##..