15 15 0
3 12
8 8
.......#.......
#.........#...#
#...###...#....
.#.####....#...
#.#..#.##.##...
#..#.......##.#
.##....#.#.###.
..#.#.#.#......
.......#....###
..#...#......#.
..#####.#......
#..#.#.##...##.
##..###.....#..
.#..#..##.##..#
.#.#....#......