15 15 0
12 14
6 7
##.###..##.##..
..#...##...#.##
.##.#.#......#.
#.....#.##.....
###....###....#
......#..######
.#.#.#....##..#
.#.........#.#.
.#.###.##.....#
#.#..#..##..#..
#....#.###.....
.....#...#.....
#.#.#....#..#..
.#..#.#.#####..
.###...#####.#.