15 15 0
9 6
5 4
##.##.#..#..##.
#.#.##..##.###.
.####..##..##..
####.###..##...
#....#...#...##
##.#.#...#..##.
...#.##.##.####
###....###...#.
.#..#.#.##....#
.####..#.##.###
...######.#.##.
....#.#.#.#.##.
####....#..##..
####..#..###..#
#.########....#