15 15 0
3 1
7 10
#.........##..#
...#.#..#.#....
..#.###.#...###
#.#.....#...#..
#..#.##.#...##.
......#..#.....
#.##...#...#...
#..###.#...####
.#..#..####...#
##....#..##.##.
#..#.#....##..#
....##.##.#....
..#####.##...#.
#.###.#.###.###
..###.##..###.#