15 15 0
4 5
2 7
.#......#..#...
#.##.#..##.#.##
#.#.##..####...
#.##.#......#.#
..#.....##.#.##
#.###.###.#....
...###...##.#..
#.#..######.###
.#..#..#.#..##.
###...#..###.#.
.#.########.##.
.##....##..##.#
..##...##.###.#
####..#.###.#.#
###.##..#...#.#