15 15 0
2 1
4 0
.##.##.##.##..#
.#...##..#####.
#..#.#.#..##.##
#.##..##.#...##
...####..##.###
.##...##..#.###
#..#.#.#..#...#
.###..#.###..##
.#...####...#..
##.##...###.##.
.#..#..##...###
####...####.###
..#....#..###.#
.#.####...##.##
..##.#..#.##..#