15 15 0
12 11
5 5
###....#.#.####
...#.#.#.##.#..
.###...#.#.#.#.
.#.#.##.######.
#.#######..####
#.##....##..##.
#.##..#.######.
.#.#.##...#.###
#.##....#...###
###.#.##.#..#.#
..####.#...####
.#..##.#.#.#.#.
#.#.####....##.
.#..########.#.
##.######..#.#.