15 15 0
2 0
3 9
.#...#.####....
#....##...#..##
..##...####.#.#
#....#..#.#.#.#
..###...#..#..#
.#.#.#....##.##
....#...###..##
#.##.#..##.###.
####..#.#.#..##
#.#...####....#
...#.###.####..
...#.##.#####..
##.###..##.##..
###.#.#..#.#.##
#...####.##....