15 15 0
5 1
8 0
##...#.#..###.#
####..##..#....
####.#.##.##.#.
.###..#.#....##
.####..#.#..###
#.#.####.#.....
#....#.#.######
.#.#.....#..###
...#.##.#..#.##
......##.##.##.
.#...###...##..
.##.#.#...#...#
#...###.#.#..#.
#.###.#.#......
#.##.#..##.###.