15 15 0
3 2
13 6
........#....#.
.######....#.##
..#..#.#..##...
#...##.###....#
.###.####..#.#.
##....#.#...#.#
..#.#.#.......#
.#####..##..#..
.####..####.###
.......###..#.#
..#.#..#.#..##.
##......##..#..
.#.###.#.##.###
#...#..#.######
#.####.##....#.