15 15 0
2 10
2 8
..#.#.#..#.#.##
....##.#..#.#.#
.##.#......#..#
.#.#.###...#.#.
.#..#.#......#.
.#.#.....#...##
#....###.#.###.
..##..#.###..#.
.##...####..#..
#######......#.
#.#.##...##..##
..##.#..#......
#.#....#..#....
.###.#...##..#.
.......#.#....#