15 15 0
1 2
11 6
..#..#.##...#..
...##..###.#...
.#...#..###..##
.#.##...#..##..
#...#####.....#
..#.#.###...##.
###.......#..#.
#.#.#.#.#..#.##
.#..##.###.....
.##.##....#...#
.####.........#
...###.###.##..
#..#.#..#.####.
#.#..#.#..#.###
##..###....#...