15 15 0
11 0
12 13
#..#####..#....
#....#####..#..
#..#...#....#..
......#....#...
#....##.#.##...
#.#..###.##.###
.....##.#.#..#.
....#.#....#...
#.##.#.#....#..
.#.#...###.##.#
#.............#
.......#....#..
#.##.....#....#
.....###...##.#
##..####..#....