15 15 0
4 4
8 3
.###.#..#.#.#.#
..#....#####.#.
###...##..#####
...##...#.#.###
#.#..####.#..##
.#..####..#.##.
.#.###.##.####.
#.....#.#.###..
###..#..#.###..
.#.#.#..##.#...
...#####.....##
.#.....#.##....
...#.#..#.#..##
.#.##.#...##..#
#....#.#.##.##.