15 15 0
10 0
9 0
#.#.#.....#.###
#.#.##....##...
...#.#..##..#..
...##....#.#...
.##.....#.#....
..#.#.#...#.#..
.#..##..#.##...
.....#..##..#.#
#.##.......##.#
.####...###..##
.###.#...######
...#...###.....
#.##.....###...
.#..##..#...#..
.#..####....#.#