15 15 0
5 11
11 7
.....#..#...#..
###....#.#.#.#.
......##....##.
...#..#...#....
..#.#....##.#..
.#.###.#....#.#
##.##.##.#...#.
....#.#........
..#.###..#.##..
.#.##..#..#.#.#
#..###.#..###..
..##.......##..
#.#..###.#....#
..##.#..#..#.#.
.###....#....#.