15 15 0
2 7
7 13
#..######.###.#
#.#.#.....#..#.
...###...#..#.#
#.##..##..#..#.
...#.#.#..#.###
#..#.##...###.#
.#.....#....#.#
.#....#.#.#....
..#.#...####..#
#.###..#....#..
.#.##...#.###..
.#..#.........#
######..#.#....
.##.#...#..#.#.
.##..#...####.#