15 15 0
12 8
13 9
#.#.##..######.
.##.#.#...#..##
#####.#.#....#.
.#.###########.
....###.##.##.#
#...#.#.##.##.#
###...##..###..
..##....#.....#
.####..#..###..
#.###...##.#...
..###...##...#.
.##..##..##.#..
#..#...#.##.#.#
.####.##....###
#####.#....##.#