15 15 0
5 11
9 6
#.##.#.#...####
.#.###.#..##...
...#.#.##.#.#..
#..##...#.#..#.
.#...###..###..
##.###.###.....
..##..#.#...#.#
#.....###.##...
###.#...#..#..#
#..#.......###.
........##..#.#
#..#.#.###.....
..#..#.#...###.
#..###.........
#..#.......#.##