15 15 0
12 3
8 5
#....#.#...#...
#.....##...###.
##....#.#.###.#
..##.###.###.#.
#.#.....#.##...
########....###
.#.#.#.#...###.
..####....#.#..
#.#...###.###.#
#.##.###..#####
##....##.....##
#..######.#..##
##..#.##...#.#.
###...######..#
########..#.#.#