15 15 0
14 6
7 3
....#.#.#.###.#
#####..###.###.
......###..####
#..#.########.#
##..#...#.##..#
.###.##.#..##.#
..#.###......#.
.##........##.#
.##.##.#.#..#..
...#.#..##.#.#.
###.##..#..#.##
.......#..##.#.
.####..##..#..#
..###..#######.
.#.###..#..#.##