15 15 0
4 7
6 0
##......#......
#..###.##..#...
.#...##..#.#.#.
.#....#.#####..
........#...#..
.#.......#.##.#
....####.......
..#.#.......#..
##.##..##......
...##....#..###
..#..##.####.#.
.#..#.....##...
...#.#.#...###.
.#.#######..#..
.#.#..##..#....