15 15 0
3 8
10 9
..#..##..#.#...
..####..###.#..
.###....#.###..
....#.#..##...#
.....#..####.#.
#..##.#..#...#.
..#.#..#...#..#
......##.###.#.
#.#..#..#.#..##
.#...#.##......
###....#..#.##.
..###.#.###..##
.#.##..##.#####
#.....#.###..#.
#.#....#.##..#.