15 15 0
11 1
9 0
#....##.#.#..#.
#.#.######....#
..##.##...#.##.
.##.......#####
..##.#..#..#.##
##..##...####.#
##.##.#########
###..#.....#.##
#.#.#.##..#.##.
...###.#.##.#..
...###...#..#.#
#..####.##..##.
.....##...##..#
##.##.#.###..##
#...#####.#..#.