15 15 0
2 8
0 9
..##.###..#.#..
.....##.#...#.#
.##..#....#.#..
..........#.###
#.#.....###..##
....#..#...##..
#..#..#.##..#.#
.#.....##..#..#
.##..##.##.#.#.
##..##..##.##..
....##.#..#..##
.#...#....###..
##...##.#..###.
........#...###
....##...#..#..