15 15 0
7 6
12 7
.##...###...##.
#.....####.###.
#.#...#.#.#..#.
.##..##.#.#.###
#.#..#...##.#.#
..###.#.#...###
.##..########..
#..##....##...#
######.#...##.#
#..###.###.###.
###.##.##..####
#.#.###...##.##
#.###.#.#...###
#####.#.##.##.#
##..#####.#####