15 15 0
6 8
4 8
############..#
##....###.#..##
######.#.###.##
####.##..#####.
##.#.##..##....
##..##...##..#.
.######...####.
....##..#######
###..###.#..#.#
..##.#.#.#.####
.#.#.##....###.
#...########..#
.#....#####..#.
#..#....#.#.##.
#####.......#.#