15 15 0
7 9
5 7
.#####..#.####.
#..#.#.#####.##
##.##..#.###.#.
##....#..#####.
#...##.##.###.#
.####.....####.
...##.#.##.###.
..###.#...#.#.#
##..#.####..#..
##..##.#.##...#
...###.#....##.
###.#....##.##.
##.#..######.##
#...#.#.##.....
####.###.####.#