15 15 0
0 11
2 13
######..###.#..
#.#...#.......#
..##.##..####..
.###.#....##.#.
#.#.#.#........
#...##......#..
.##...###....##
#..##..#.#...##
..#....##.###..
#.#..##.#..#...
.#.#..#.#.##...
..#.##..#.##...
..#..###.#..#.#
.###.....##...#
..####....##.#.