15 15 0
5 14
4 14
.#.####..###.#.
#.#...##....###
.....##.#..###.
###########.#.#
.###..#..#####.
####..#.####.#.
#.#.#.####.##.#
#..#####...####
#..##..#...#.#.
##.#.####.....#
##########.##.#
####..###..#...
##..#..#..#..#.
###.....#..###.
####.#.##.##..#