15 15 0
7 4
4 3
#..###.#.######
..#....#.###.##
##.####......##
##..#.#..###.##
..#.#.##..#.###
.##.####..####.
#....#.##.###.#
.###..####.....
#.##..#.####..#
#####...#..#...
##.#.###.#.##..
##.###.#.##.#.#
##.####.#####.#
..##.#..##.#.##
.##.##.######.#