15 15 0
10 8
7 14
###...#..##....
....##.#..#....
..#.#.#..##..#.
.##..###...#.##
#..#.....######
.####...#.#....
#..#..###...##.
..#..###.......
.#...#.#.##....
..##.##..#...##
#...#.##.#..###
...#...#.#.#...
##..#...###.##.
.#...###.#..#.#
.##.###.##.##.#