15 15 0
7 9
9 8
#.#..###...##.#
###.#..###.....
##.....#.#.#.##
.#...#..##..##.
...####..##..##
....#..#......#
..###..######.#
..####..#......
##.###.#..#.#..
.#...#.#..##..#
.#..#.###.##...
#####...#.....#
.#.##.#.....##.
#.#..###....#.#
###.#...#.##.##