15 15 0
2 4
10 3
...#..##..#####
......#.#..###.
..#.....#.#.#.#
.#.#....#......
#.#.###..#....#
#####..#......#
#.#...#.#.#..#.
#..#.#....###.#
.#......#.#.###
..#####..#....#
#..........#...
#...#.###..#..#
#####..####....
.#...#..##....#
###.#.#...##.#.