15 15 0
1 10
0 8
#..#.#....##.#.
##.#...##...#.#
.###.###..##..#
.........#...##
..#........#..#
######..#..#...
.#..####.##....
#......##...#..
.#...##.###..##
...##.#...###..
..##.#.#.#.....
##.#.##...###.#
..########...#.
.....####...#.#
##.........#.##