15 15 0
3 7
7 5
#..#...##......
..#.#..##..#...
#...##...#.....
...#.......#.#.
#.......###..#.
..#......#....#
.####...##.##..
##.#....####...
..#...#...#.#..
...#..##......#
#.#.##.##....#.
##.#.###.#...#.
.###..##..###..
.#.##..#.......
...#.###.#.....