15 15 0
8 13
14 3
.##.##.##.#.#.#
..##...####.##.
...##.#.#.#...#
###.#.#.##.####
#...##..###.#..
..#..###..#.#.#
#.....######.#.
.##.#......##.#
.#.####.#...#.#
.#.#..#..#.##..
...#.#...#....#
..##.##...####.
..#.....##..##.
##..##....#.###
##..##.......#.