15 15 0
14 0
7 14
.#...#..#.#.#..
#........#..#.#
#..##.##.##..#.
##.##.....###..
##..###.#.###..
.#.##..#....#.#
#....#.##..##.#
###.#..#.#.##..
.....##.#......
..#...####..###
#....#...#..##.
#......#....#.#
.#..#...##.#.#.
...#..##.#####.
...##.#......##