15 15 0
2 5
3 3
#...###.###..#.
...###...#...##
#..#......####.
#.#.##..#####..
.##......##...#
..#...#..#.#.#.
#..###...#...##
#...##.###.#..#
......#.....#.#
#.....##.##..##
#..#.####.###..
#...#....##..#.
#.#.##..#.####.
##........##...
....#....#.#.#.