15 15 0
8 12
3 3
#...#...#.....#
#.......##....#
.#.###..#..##..
.......#.#.##.#
...#.....##...#
##.#..#......#.
.###...#..##.#.
##.....#...##..
##........##...
#...#...##.....
#.#..#.....#.#.
##..#..####.##.
##....#..#.###.
....#....######
.##.#######.#.#