15 15 0
12 7
7 7
#.#####.##.##.#
.#...###..#.###
#..#..##....###
#.#..##.#...##.
.#.#.##.....##.
..#..##.#...##.
.##.#..####..#.
....#.#....#..#
...#.#...##..##
.#.###..#.##.##
.#####...#.#...
#....##..##..##
.#......##.#...
.##...#..#.....
#.##...##.##..#