15 15 0
13 1
11 11
..#....####....
#.##.###.#..#..
#.##.#...#.####
..##.#..#..#.#.
.##..#.#....#.#
##.##...##....#
##...#..##.#...
.#.#.#....####.
.#.#.#.#...#...
#####.......##.
.#.#......#####
#....#..#.#..#.
..###........##
#.#..###...###.
#.....##...#...