15 15 0
8 12
13 10
####..###..#...
.#..##..#...##.
##.#####....#..
###.##..##.#..#
##...#....#####
#....#..###...#
#..#.###..##.#.
###.###.####.#.
.#....###..#.#.
##..###.#..#...
.##...###.#..#.
.#...#..#.###..
#.#.......#.#.#
.#.###.#....#..
.#..##..##....#