15 15 0
11 8
7 4
#.##.##..####.#
..##.#.#..###.#
.#..#...#####..
##....#..#..##.
.##..#.#.#.#.#.
##.###.....#...
....###.##.##..
#.#......##..##
.#.....#..##...
######.#..#####
...##..#..##.#.
###..#....#.#.#
.#####.###.###.
..#...#####...#
.#.#####..#...#