15 15 0
9 8
7 7
#.....#..##....
####..#..##...#
#.#..#.#.......
#.....#.##..##.
..##.###..##.##
....#.......##.
#...###...#.#..
.#...#..#......
.####.#......##
......#..#...#.
#...###.#...#..
.....##..#...##
##.#.#..####..#
.#....#...#..#.
.###..#.#...###