15 15 0
11 1
7 13
#.#..#.#..#....
.....##.....###
##..#..#....#.#
#...##.......##
...........###.
..#..##....####
#...#.......##.
##....##.#....#
..#..###.##.#.#
#...#..#....#..
.#....#..##..#.
.....####.##..#
.....#...#.####
.####.....#....
..##...#.######