15 15 0
4 7
3 7
.###.#.#.######
####.#########.
#.#######..####
####.##.#.#.#..
####.##..##..##
..###.####.####
.#.#.##...#####
##..#####..#.##
##..#..##.###..
######.#####..#
##..#.######.##
.##...#########
.##..##..######
.#..########.##
##..###.#.#.###