15 15 0
7 7
8 7
.#....##.##....
#.#..##.#......
##..#.##..#..##
.#.####.##.#.#.
..#.####.#....#
.#...##..#.####
#...#...#.#.###
#..#.#..###.#..
#.#..#..#.....#
.###..####..##.
.#...##.....#.#
##.#..####..#.#
.......#..#....
##......#...#..
..#...#.#.###.#