15 15 0
1 6
13 12
#...#.#.#..##..
#.#.#....#.##..
#..##.##..#..##
.#.#..##....#..
.#........####.
#........#...##
#.###...##.#...
..#...#......#.
.###.##...##..#
....#..##.#....
.#.#...#..#..##
.####..#.#..##.
#..#.##.#.#..#.
.#......#..#.#.
#..#.#....#...#