15 15 0
6 4
9 1
.######.##...##
########..###.#
...##.####.#.#.
.#####..#.#..#.
.##.######.#.##
.##..#.##.#...#
#.#...##.##..#.
###..###.#....#
#........##.###
#.#.##...####.#
..#..#.##..####
#.#.##.##.#..##
.#..#####..##.#
.#..##.##..#...
...#....#######