15 15 0
7 11
7 0
##.#..#.....#.#
........#...###
#..#..####..#..
##....###...#..
.#.#...#....##.
#.##.....#..#.#
.....#..#.#....
..#..##.###....
#..##...##.##..
#.....##...###.
....#....###..#
.#.#.#.#...##..
#..#..##.#.###.
..#...#.#...###
.#....#..###...