15 15 0
1 10
2 9
.##.######..##.
##...##.##.###.
#########..####
#.####.#....###
####.###.#.####
##.#####.######
##.###.###.##.#
..#.#..####....
####.#.#.######
####..#.#.#####
..####.#.#.#.##
.##.#.#.....###
#..######.##..#
.###.######...#
#...#.#.###.##.