15 15 0
5 9
8 8
....#.#...##.#.
#..##.#.##..#..
#.#.#..#..#..##
#.##..#....#..#
.#.###....#####
..##......##...
.#.#.####.#....
.#####.#...####
##..#.##.##.#.#
#.#..####.....#
.####......##.#
###.##........#
#.....###..#..#
..#...##.....##
#####.#.#.##.##