15 15 0
12 13
3 8
....##..##.##..
..##.##.#######
##.#....#.#.###
.#####.#.....##
...#..........#
....####....#.#
###.#.##.#.###.
.#.#.#.#.#.###.
.#..#...#..##.#
###.#.####.....
.##.#.#.##..#..
#...###.##.##..
.#######.#.#..#
...##......####
.#.######...###