15 15 0
2 14
7 10
...###.##...###
.#.....##..####
#.#####.....#..
#..#.##.......#
.#######....###
#....##...##.##
.#...##.#.#.###
#..##......###.
........#.#.###
#.##..###.#....
#.....#......##
..#.......####.
#...##...#..#.#
.#####..####.#.
#....#....#..#.