15 15 0
7 13
11 11
.##.###.###..##
###.##.########
.#..#####.#####
#.###.##.#.#.##
#..##.#.###..##
.###...#######.
.##.##.#.##..##
#...#...##.##..
#####..#######.
#.######..####.
###.#.####.....
..####...##..##
#.#..#....#.###
##...###.##.##.
....##.####...#