15 15 0
6 11
0 8
.###.##........
..#..#...####..
....##..####.##
#####...#.#..#.
#......#..##...
#....#....#...#
.#...##..#..#..
.#...##..#....#
###..#.#...#..#
###.#.#.###..##
#...#........#.
#.##.###...#..#
.#......#...#..
...#.##.....#..
#..##..#.##..##