15 15 0
10 8
14 8
###.#.#####.###
..#.###.##.###.
#.....##.#..##.
#.#######...#..
#.#.###.##....#
#.########.#.##
#..#.##..######
..#.#####.##.#.
..##..#.#..###.
##...#.#..##.##
##........#.###
##...#.#....##.
.###.##..##.#..
.##.##..###..##
#..#..#...####.