15 15 0
0 7
8 6
##.........#...
####.#...####.#
###..##.#######
#..###..#.#....
..#.##....#....
#..#.....#.#.##
.#.#...........
.#.......#.##..
...##.........#
##.#...##.#####
.######.##.###.
#..#...#....#..
....#...##.#.#.
#.#...#.....##.
#.#..##.##..#..