15 15 0
5 11
10 14
##.....##..##..
##...###...####
####.#.#..##...
..############.
.....##.######.
#.###.#.#.#.##.
#####.##.##...#
.##.#..##.#.#.#
#..##..#####...
#.####..#..#.##
##.#.###..#....
..##.#..###.###
.#.#####..#..##
#..###.###.##.#
##.#..##...##.#