15 15 0
3 11
12 6
#.#.#...#.#.#.#
..##...#.#....#
##......#...##.
.#...#.#.##..#.
.#.##..........
...###....#.#..
.#.##.##.#..#..
#.......##.#.##
#........#####.
#..##........##
...#....##...#.
#.#..#...#.#.##
.#..#...#.#..#.
##.#.#..#.##..#
...............