15 15 0
4 9
10 6
.###.#.##..#...
..###.#.##.....
..###.##..#....
#.#.##.##.....#
...#.#.......#.
.....##...###.#
#...##...####.#
.#....#....#..#
..#.....#.##.#.
#.#..##....##..
##..##..##.....
.........###...
.#....###.#..#.
...##....#..###
##..#..#..###..