15 15 0
3 14
9 14
..#.#.#..#..#.#
##..#...##.##..
.......#.#..#..
#....#..#..###.
.#.###......#..
.#..##.#####...
####.##......##
..###.#.####.#.
...#.#.#...#...
#####.#..##.#..
...#.....#.#...
.#..#.#..#.....
##..#.##.#.####
#.......###....
.#..#...##...#.