15 15 0
5 3
10 5
..##.#....#....
.#....##...##.#
#.###..#..##..#
..######....##.
#.#.#.#.....#..
..#......#..###
...#.#.#######.
.##.#..#...#.#.
.#.#..##..##..#
..#...#..##.##.
....#..##..##..
#.###.####.###.
.#.......##...#
###..###.#..#.#
.###.###....###