15 15 0
7 8
0 7
##.#.##.#.##.#.
..#..........#.
.##....##..###.
..##.#..#...##.
...###..##..###
##..##..#..#.##
.#........#..##
#..#..##.#.#...
###.##.#.##....
..##.#....#..#.
###.###..##..##
##......###..##
#.###.##.....#.
.#..#...##.#..#
#.##.#.#..##.##