15 15 0
1 10
4 8
###.###.#.#.##.
..###.##....#..
.###..#..#....#
##...#....#..#.
##....##.##....
##.....#####..#
..#####....#...
.##.#.#...#.###
.#####.....#..#
#...#.##....#..
##.##..###....#
#.#.....####..#
###.##.##..#..#
.##...#....#.#.
#.#..#..##.##.#