15 15 0
6 9
3 13
.#..##.........
..#..#.##.#.###
###.##.#.#.#..#
####.#....##...
..#...#.#####..
##.######..###.
####..#.....##.
.....#.##.#....
##..##..##.....
......##...#...
#..#........##.
#.#...#.##.#.#.
#.....##.#.#..#
#..##..####.#..
#.####.#.#.####