15 15 0
12 12
0 9
.#..###....##.#
..#..#..#.#...#
#.#....#.#...##
####...##..##..
#.#...##..#####
#....#..##.##.#
...#..##..##...
.###..#..#.....
.######....##.#
....#...#...#.#
.#........#...#
.#...#...#..##.
......###......
#.#.#....##...#
...##..#...#.#.