15 15 0
3 5
3 8
.##...##.##.##.
.##......##..#.
#..#.####.#...#
.#..#......#..#
#.#...#..#..#.#
#.#..#######...
#.....#..##...#
##....#.#.###..
##.#...#..####.
#.....##...#.##
..##...#.#..##.
..#.##...#....#
....#.#..#...#.
#.#.....#..###.
...##....#....#