15 15 0
3 5
7 4
#.#.#####..###.
####.#######.##
....####.###.#.
##....##.#....#
..#....#...#.#.
#.#.#.#.##..#..
.##.#..##.#..#.
##.#..####.##.#
#.##....#.#.###
#########.#.#.#
###..#####.#..#
##.#...#.#.##.#
###########.##.
#######.###.#..
##.##..##......