15 15 0
13 4
12 5
..##.###.#.###.
#.####....###..
......#........
....#...###.#..
.###.#......###
.##..######..##
..#.#...#.#..#.
...#.#....##...
.##..#....##.#.
.##...##.#..###
.##.#..##.#.##.
##.....#..##...
....#.#######..
#..#..###..####
..#.#.#.#.#.#..