15 15 0
4 10
9 10
.#..#.#....##..
####....##.#.##
..#....#.#.#.##
..#.#..#####..#
...#...#.#.###.
...#.#.#...#..#
.#....#..##....
.....##.#.#....
....##....##..#
......##....##.
#...#..###....#
#.#..####.##..#
#####..##.#..#.
.#...#.#.#..#.#
.##..##..##.##.