10 10 0
2 1
1 3
#...#..###
....##..##
..##..#...
..#.......
.......#..
..#...#.#.
...#.###..
##..#..#.#
..#.#.##.#
##.#.#####
