15 15 0
3 12
12 7
#.....##...##..
##.........####
#...###....#...
#####...#..#.##
##..#....#...##
###.#..#..##..#
.#.#...##..#...
####.....#.#...
...##....##.#.#
###.#.####....#
.##.#.#..###.#.
##.#...#...#..#
..........#....
##....#.#.#....
###..#.##...#.#