15 15 0
6 5
7 0
...##.#..#.....
.#...#.#..#..#.
.#.##.#...#....
.###....#..#...
###.........#.#
..#.#.#......#.
..#.#.##..#...#
.....#..#......
#..##..###..##.
#.....#.##...##
..#.##..#..##.#
..###...#.....#
#....#######.##
....#.#..#.#...
.#....#.#.#.###