15 15 0
9 5
1 2
.#......##....#
...#...##..#...
#.#.#...#.#..#.
#..............
#..##.##..#..#.
#...#...#.##.##
##.###....##...
.#..##.#.#..#.#
..##....#....#.
###......##.#..
.#.#.#...###...
#.#.#..#.##.###
.....###.#..##.
..#...##...###.
...#.#...#.#.#.