15 15 0
8 13
10 7
....###..##.##.
......##.##.#.#
...#....#..####
.##.#.......#..
......###.####.
######....#.#.#
#.#.#..###....#
..#.#.###......
####.###.##.#..
....#.......###
#...##.....#.##
....#.#..#....#
.###.#.#.#.####
##.#.##.....#..
..###.....####.