20 20 0
2 14
2 19
.#.#.##...#.#..#...#
...###.....#####.#..
...###...#.###......
#....##..###.###..##
##.#...##.#..##....#
##.....#.....####.##
#.#.....##.#.#..###.
..#....#...###......
#.##.#.#.#..####....
..####.#..#.....#.#.
#.#..#.#.##.##......
.##...###...###.####
#..#.......#.....##.
....##.#....#...#.##
..##..##.....#.###.#
##..#.....#.#...#.#.
#.#.#.#.####.#####.#
##......#######.#...
...##..#...#.##.##..
.####..........###..