15 15 0
3 12
10 2
.#..........##.
..#......#.....
.#.##..##..#.#.
...##.##......#
#.#.###.###..#.
.#.###..#...#.#
.###...........
....#...#.#.#.#
#..#.........##
#.#.....#.#....
#..#..#........
.#...###..#.#.#
...#....#.##...
...#..##.#....#
.....#...##...#