15 15 0
1 12
3 5
###.###.##.....
...#.#.#.....##
#.#.#.#..#.##..
#.##...#....#.#
#........#.####
..###.#..#..##.
#.#.##.#.#.##.#
.###..........#
#.####....##...
#.###....#.####
##..##..##...#.
#.##.###.#....#
.#..#.#.####...
...#...####....
.###...#..####.