15 15 0
11 7
7 5
...#...#.##..##
...#.##.###....
##...#....#.#.#
.####.####.###.
#.#.####...###.
....###.#......
..#..##..###..#
...#....#..##..
######..###.#..
#...##...##...#
.#..##....##...
....##...#..#..
##.#...####.#.#
....########.##
..#...#....#...