15 15 0
2 1
2 0
###.###..##.#.#
....####.####..
..##.#.##..#..#
.####.##...####
#..#.####.#####
..##.##.#.#.#.#
#.##....#....#.
.######.#..#..#
####.#..#..#.##
#.##..##....#.#
#..#####..##.##
.#..####...####
.##.##.#####.##
#.####..##..###
#..#.######.#..