15 15 0
6 11
8 9
.#.#.#.....#...
......#.....##.
.......#..####.
##......#.....#
#..#.........##
.###....###..#.
##.#..#.....#..
#....##........
##......#..#..#
##.###..####.#.
.....##.#......
...#.#....#.##.
..#...###.####.
....#..##......
##.#...#..####.