15 15 0
6 0
9 4
...#....##....#
#.##....#..##.#
##...#.....####
#.######.##...#
.#.##...##.....
..####..###..##
..####....#..#.
#...#...#.##.##
#....##.#.#....
.#.#..#.#.#.###
.###..##.#.####
##..#...###.#.#
.#.########..##
....###......#.
#...##...#.##.#