15 15 0
2 12
3 5
.#....####..##.
######.#......#
#.#####..#.#.##
.##.#.......#.#
###.#..#...###.
..##.....##.#..
#..#####..####.
.#.##.##....#.#
###.#.#.#######
..#..#.#.#.##..
.##..###..####.
##....###.###.#
###...#####.#..
..###.###..####
#.#.#####..#.##