15 15 0
9 14
10 6
..#.#.#####..##
..###.#...#..##
#...#...#......
...##..#...##.#
##.....#..#....
.##.#.##....#..
#.....#.##...#.
###.##....#....
..#..######....
#....#.##.#.##.
##.....#..#....
.#.#.......#..#
..#.....#......
#######.#....##
#...#.##.....#.