15 15 0
3 9
2 11
#.#.##.....#...
..#...#.##....#
#.##.........#.
.#.#.#.##.##.#.
#..#..###.##...
....#.#...##...
.###...#..#..##
.#########.####
...#.#.###...##
.#.....###...#.
.#..####..##.##
..##..##.#.#.##
#####.#########
##.###.#.##....
.#######....###