15 15 0
13 3
12 9
###.#..###.#.#.
##.#..###.#..#.
....#...#.####.
####.##..##....
.##..###.....#.
.##....#....#.#
....##...#.#..#
.........#..###
...##..##..##..
#.#..##.#..#...
##..#.#.##..#.#
#.........##.##
.#.#.#.##.#.#..
....####..##.##
...##..#...##.#