15 15 0
2 5
12 7
###....#.##..##
#.#####....###.
..#...##...#..#
.#..##.##.....#
......#....##..
....#........##
#.....##.#####.
###..#.....#..#
.#...#..###....
.#...#..###....
#..##......#..#
..#.#.#.......#
##...#..###.###
...#.#....#.##.
#.##.....##..##