15 15 0
14 3
3 9
.#.#...#.######
.#.....#..#..##
..##.....#.#..#
#...#...#..####
####.....#.....
#.#..#.......#.
.#####.#.......
#....#.#.##.#..
.#...#...##.#..
#.###..##....##
.###.....#..#..
##.#..#.#....#.
#.#...#.#.#....
.##.#..#.....##
..#.###....###.