15 15 0
3 14
1 2
#.#...#.#.##...
.#...#....#....
.#..#..####..#.
.##.#..#...#.#.
.#..#.###....##
..#.#.##....#..
..#......#..#..
.#.#.###.#..###
#.#.##.###...##
#...##.#####.##
..#..####...#..
#.##......#..##
#....#...#####.
#..###...##....
.#..##.#.#.#..#