15 15 0
10 3
10 1
.....#....####.
##..#.#.#.#.#.#
.###.#.##....#.
..#.#....####.#
.#.#.#....#..##
.##.....#.##...
..#.##...####..
..##..#.#.###..
#...#.#.#.#....
.###...##.#####
....#.######.##
....###.#..#...
####....##.####
.##.#..##.#.##.
.#.#...#....#..