15 15 0
7 5
5 1
....#....#.....
..#####....##.#
..#.....#.#...#
#..#...#.##.###
#.#.#...##.#..#
..#...#...#..##
..##..#....#..#
........##.#.##
.#.#####....#..
#..#.##..###.##
.#..##.#.#.##..
...##...#..#.##
.##.#..#..#....
##.#.......#.#.
#.#..#.####..##