15 15 0
12 4
13 7
...##...#.#.###
....#....#.#.#.
#...###.###..#.
#...#...#....#.
.####.#.#....#.
#.######.#.##..
...#...#..#...#
#....#.....##..
.#...##..##..#.
#..###..##.###.
##........#...#
#..##....#.##.#
.#.#..#..##.###
..#..#....#....
#.#.#..#..#.#..