15 15 0
1 7
6 3
.##...#..####..
..##......#...#
..#.#....######
..#..##...#....
..#.....###....
.#.......#.#..#
.##..###..##...
.....##...#.###
.###...#.....#.
..#..##...#.#..
#####.#.###...#
##.#...#.##..##
...#..#..#.#.##
.#.....#.#..#..
....#.#..#...##