15 15 0
6 11
11 5
..###....#.#...
.#...#..##....#
.#...###..#.##.
.....###.#.#.##
.##...#.#.#.##.
..###...#..###.
.#...###....#.#
...#..#.#.#....
..###.....##.#.
.##........#...
.......###.#.##
#..#...#...#..#
..##.....#..#..
#####.#.###.##.
###.....#.#..#.