15 15 0
10 12
7 6
....###..#.#..#
....#......#.#.
##....#..##..#.
#..#..#.#.#....
#..#.....##....
...#...##.#..##
.#.....##...#.#
.....#.##.###..
...##.##.##...#
##...#...#.##..
##.#..#......#.
.#.##...#.#####
.#....###.###.#
...##.#...#.#.#
#...#.##......#