15 15 0
12 14
9 11
.#...#..#######
#.#.#.#.#...#.#
.#.##..###...##
#.###..#.#.#...
.#######.##.###
.##......#..##.
#####.###..#.##
.#....##...#..#
##...##.##.#.##
##..##.###...#.
###.#..#...#.##
....#.###.#....
.#######.#.###.
####.#..####.##
..#.#..##......