15 15 0
1 13
2 11
####.###.####.#
########.##....
###..####.#.##.
##.#...####.###
######..#.###.#
####.##########
###############
#.#...#########
#######.#..##.#
.....#.#####.##
####..##..##..#
#.#.##....#####
##.######...#.#
.###.#.####.##.
######.#####.#.