15 15 0
0 14
2 6
........#..#...
#..##.#...#..#.
#.#............
.#...#....##...
....#.#......#.
.##.#..........
#.#.#.####.#.##
.#..#.##..#.#.#
..............#
##.##...#......
..#.##...#.....
.#.#....##...##
.#.##..#..#####
.#.#####....#..
######..#...#..