15 15 0
11 5
8 0
#..#...#.##....
.###.#.#.##....
...#.#.#.####.#
#..##.##.......
#.##.##..#.#.#.
.#....##.....##
#.......###.##.
.##..#.#...###.
...#.....###.#.
#.....#######.#
.#.#....##.#...
#####..#.....#.
#....##........
#.##..######.#.
..#..#...#.....