15 15 0
8 10
10 7
....###..#..##.
#..#..#.#.##...
#.#.#..##..#...
.#..#....#...#.
..##......##...
....#####....#.
.#.#.#.........
.#...######.##.
....#........#.
#.##.......#...
###..#..#...#..
#.#.##....#.##.
##..#.#...##...
.#.##..##...#.#
.....#..#...#..