15 15 0
10 2
10 5
#..##.####...##
..###....#.##..
..##.#.########
######..#....#.
..#####...#..#.
####.##.###.##.
#.##..####...#.
.#..#.....#..#.
##.#########.#.
##.#..##...#.##
#.....#.##.#...
##..###.##.#.##
#...#.###.##..#
..###..##...#.#
.##.#.#.#.#..##