15 15 0
2 5
6 1
..##....##.#...
#.#.###..##.#..
##............#
.##.###..#.#...
#..#.#..###..##
......#.....#.#
..###..........
#..##.#.....#..
..###.#..###...
.##..##.#...##.
#....#..##.#.#.
#.....######..#
#...#....#..#.#
.##..##.#.###.#
#..#.##.#...#..