15 15 0
6 9
10 11
..###..#.#...#.
........####.##
#.####..#.##...
..#####..###.#.
##.###..#.#..##
..####.#.###.##
...#...#...###.
...#.###.#.#..#
#......#..##...
#.###..#..##.##
...##...#...###
..#.#.####.....
#.#..##.###..##
####..##.......
#.###.####.####