15 15 0
9 2
8 11
.#.#.#.##.#.#.#
...##.#.##.###.
..####..##..#.#
.#....##...###.
....#....#.#.#.
..#...########.
.#..#...###.#.#
#.....##...#.#.
##.#..#.#.#...#
........#...###
###.#...#.##..#
....#.#......#.
#.##..#...###.#
....###...###.#
.......#.#.#...