15 15 0
2 9
1 14
..#..#.#.#.###.
.#.#.###.#.....
#.#####....####
#..####...#.#..
##........#.#.#
..#.....####.##
#.##.###....###
.##.######..#..
#.####.#..###.#
##.#######...##
#.###....####..
#.##.#.#.###.#.
.#.###.#.###...
###.#.#.#.#..##
......###.#.###