10 10 0
8 8
7 3
#.#..##...
..##......
...#.##..#
....#.....
#.#..#....
..###.#.##
...##.#..#
..#....#.#
###......#
..######..
