15 15 0
8 13
8 3
...##...###...#
.###..#.###.#.#
####......#.#..
.....####.....#
....#.#..###..#
..#.#....####.#
#.....#....#..#
#....##...#....
......#.#.....#
...#.##...##...
#.#####...##...
...#....#......
###......##..##
##.#.#.#.#.....
...##..###...#.