15 15 0
8 14
11 12
#..###..#...#..
#............##
#.#....#.#.####
..#.##.###...#.
#..#.......#...
..#.#.#..#.#.#.
.#.###.##.#...#
.#..##......#..
.....##...#.##.
#.#..##...#.##.
#...##.#...#...
#.##.#.#.#...##
##..#..#....##.
.#....##....###
..#.........#..