15 15 0
6 1
1 8
.###..##..#..#.
......##....##.
##..#....#.#.#.
..#..#....#.##.
....#.#.####..#
...#.#.#####.##
.......##..#..#
#.#......#..#..
##.#########..#
.#..##.....#...
##.#.##...##.##
..#...###.##...
##...###..#..#.
...#........#.#
.#######..#####