10 10 0
5 1
5 0
.#.#.##..#
...#.#.#.#
#.###..##.
##.##.#.##
###.##.###
...##....#
####..#.##
.#...##.#.
#...#.##.#
##..##..##
