15 15 0
1 10
3 5
#...#.##.......
##..####.#..#..
#.#..#..#..#...
..#.#.....#.#.#
#.#.#.#..#...##
.###.#.#..##...
#..#...#...###.
#....#.#.##....
....#...#.#.#..
.###..#..#.....
.#.....#...#.##
#..##.#..##..#.
#..#...##..##.#
..#.##.#.#.###.
...#...##....##