15 15 0
3 5
9 8
.#..###..#..###
.#.##...#.#..#.
....#..##.#.#..
..##..#........
.###.#....#....
..##..#.#.#.#..
...##....#.....
.#...#..#.#.#..
.....####....##
...#.#.#..##.#.
.......#####.##
.###.#.#.######
#....#.####....
..#...#....#...
..#....###...##