15 15 0
5 14
6 13
##...##...#..##
.##..##..#.##..
...#..##..#....
##..#..#.#.#...
#........#.#..#
##.#.#.##..##..
##..#....#.#...
.#..#...#####.#
#..#.#...#.#.#.
..#.#.#..####.#
..#.#..#.#...#.
.....###.....#.
..#..#.#......#
###...#.###.##.
..##.......##..