15 15 0
3 3
4 3
.#...##.#.#.#..
...#.#.#......#
.#.##..######..
......#.#.##.#.
##...##...#####
.....#.######..
##.##....#.####
.#.##.#.###...#
.##....#..###.#
#..##..#.###.##
.....#..##.#..#
#.##....#..#...
....#.##..#.###
..#.###.....#.#
....######.###.