15 15 0
8 12
8 13
#.#.#.##..#.#..
...#.#.##.....#
#.....#...#.#..
#...#..###.#..#
##.##...###.#.#
##.#..##....#..
###.#.#..#.#.#.
#..###.....##..
..##.##.#.#....
#....####.##..#
.#..#..#..#..#.
..##.#....#...#
##...###.##.#..
#....#....#....
..#############