15 15 0
6 10
6 7
###..#.#####...
##...###.##.#..
..#...#..###.##
#.######.######
##....#########
...##....#.....
...#.##.....#.#
#.#.#..#.###.#.
#######...##.#.
.#...######.#.#
###..#.##..#...
#.##...###.##..
.#...#.#...####
...#..#.#..###.
.###..##..#..#.