15 15 0
8 11
6 0
....#.#.#.#.##.
.#.#######.##.#
.###....#####.#
...###.#.......
###.....####..#
..##...####..#.
...#.......#.#.
#......#....##.
#.#.#.#...#.#..
####....#.##...
.#..##..##.###.
..#.....#.#..##
#.#...#........
#.#...#..######
#..##.##.#....#