15 15 0
9 3
6 2
.....#.....##.#
.#.####..#.#...
.#..#.##..##..#
..#.......####.
.#..##......#.#
.#..#.#.###.##.
#..####.....#.#
#.#...#.#.....#
..####...#.###.
....#..#...####
...##.#.#.##..#
..#..#..#.#..#.
...#.#.#.#....#
#......#..#.##.
.#..#.......#..