15 15 0
9 14
8 13
...#.....#...##
##.#.##....#.#.
##.#..####.#.##
#....##...#..#.
..#.##...#.####
..##.#.###.####
##..#.##..#####
.......#.#..#.#
...#.#..#......
.###.#.#.###.#.
.##.....#.##..#
.#....##..#.##.
#..#.##.##.##.#
#.####.#####.#.
.......#..#.##.