15 15 0
8 6
8 3
.#.#...#.......
##.#.##.##...##
##...#.....##..
###..###.....#.
.#..#..#####..#
###.##....#.#.#
#..#..#..##.#.#
....##...###...
#.#..#.#.##.##.
..#......#..##.
....##..#.#..#.
#..##.....##...
#.#.#.#..##..#.
##..#.###..###.
...#...........