15 15 0
8 7
2 2
.##.##.##.#.###
##...#...####.#
##...#...##...#
###..#...#.....
.##....##.####.
#..#.#..##..##.
######.#.#.##..
.##..#...#...#.
.###.##.#####..
...#...##.#...#
..#.###..##....
###...##......#
#.###.#.#..#...
.##.##...#.##.#
..#.#...#...###