15 15 0
6 2
10 8
.##..#.##..#.##
...#..#.#......
#.#...#.#.##...
.###.#.###..#..
.#.#..#..#.###.
.........#...#.
##........#.##.
......#..#.....
.......###.....
..#..#..#.#..#.
.###.......##..
###..#.##....#.
##.###..###.#..
##.#..#...#....
..####.#...##..