15 15 0
8 9
9 6
.##...####.##..
.#...#.##.##.#.
.##..##..#..#..
..#..#...###..#
.#.##..##.##.##
..#..#.#...###.
.###...##.....#
...#.......#..#
...#..#.#.....#
#.#.#...#.##...
.###..#.#....##
##..####.#...##
###.#...##...##
.....#.......#.
...#......#..#.