15 15 0
1 3
3 9
...##....#####.
......#...##.#.
#.#.####..#....
##.##..#..#..#.
.##..#....###..
.##........####
.#.##......###.
.###.#..###.#.#
.#..#.##.#.##..
.......#####...
..#.#..##......
.#.####.##..#.#
##.#.#...#..##.
..##.#......#..
....#...#...#.#