15 15 0
8 4
2 8
.##....#.#...#.
.#...#.#.......
.#####.....#...
.###.###.##.###
#........#...##
..#.#......##.#
.#...#.#.#.#..#
...#.##..###..#
#.#...###..#...
.#....#.####...
..##.###.#.##..
##.####....#.#.
#.#..#....#...#
###.#.##.....##
..######..#....