15 15 0
11 2
13 1
.##.#...#.....#
.##.##....#...#
.#.#....#..##.#
.##...#...#.#..
..###...###.#.#
..##..#..#.##.#
.#.......##..#.
###...###..#...
..#.#.#..#.#...
..#.##......#.#
#.#.#.##.....##
.......##.#....
..#....#...###.
#...##.....##..
.#.#.#####..#.#