15 15 0
3 6
9 3
...##..###...##
##.###.......##
#########..#.#.
###.##...#.####
#.#.#...#.##...
.###..#...#.###
.##....#.##...#
#..##.#.#......
#..##.###...##.
....#.#..##.##.
#.#...##.##..##
###.....####...
..##.#..####.##
..#....##..#..#
.##.#.#..##.#.#