15 15 0
11 3
5 9
#.#######.#.#..
.....####...##.
.##.#####..##..
..##..#......#.
#..#####..###..
......##..###..
#.....##.##....
.##........#.#.
.##.##...#.....
#........###..#
.##...##...####
..#.#.#.##...#.
.#####.######..
....#...##.#...
......#....####