15 15 0
13 6
13 5
.#..###.#.#....
#.....#....#..#
#...#..######..
###.....#.###.#
####...#.##.#.#
.#..#.#####.#..
#.#.##.###.#.#.
..#.##...##..##
#####.##..#..#.
..###...#######
#.#..#...#.#.##
.#.##.#.###.###
.######...#.##.
#.#......##..##
###..#.#...#.#.