15 15 0
7 0
9 2
.....##..####.#
###...##.#.####
....#.##..##..#
#.#..##.##.....
..#..####..##.#
######.#.##...#
..##...#...#.#.
.#..#...#......
...##...###....
...##..#....###
###..#.........
####....##.####
.#.........##.#
..##...#.......
#..##.....#...#