15 15 0
3 2
0 9
#.......#..#..#
....##........#
#.#..#..#...##.
........#..#...
#.#......#.....
.#....#...#....
#..........#...
##.#....#.##.##
...###....#.#.#
...#..##..#..##
.#.....#.###...
..##..#...###.#
#..#..#...#...#
...##..#.#.###.
.#...####.#####