15 15 0
14 6
14 8
###..##.#.#####
######.##.#.#.#
.###..####.#.##
##..##.######.#
#.#......##.#.#
#.#.##.###...##
.#..#.####.#.##
...#######...##
##.###.#.###.##
#..####....#.#.
#...#.#.###..##
#.##.#..#..#.#.
####..#.#######
.##.#..######.#
...##....####.#