15 15 0
9 2
12 6
...###...##.#.#
##.#####...#..#
........#.##...
.#.##....###.#.
#.....##.##....
..#.#.####.#.##
##.##..##.##.##
#.##.##.###..#.
#.#....#.##....
#...#...#.###..
.#.##.#.#..#...
##....#.###...#
..##...#.#..##.
..##..#.#......
..##..#.##.##..