15 15 0
9 9
7 11
.#.##..##..#..#
...##..###.#.#.
.#.#####.#.##..
#.##.####..#..#
.#..#.##.##.#..
######.##.#.###
##..####....#.#
##...##..#....#
.#.###.#.#.#.##
.#.##.....##.#.
###.#...#..#.##
.#.#..###.##.#.
##.##.##.##.#..
###..#.#.##....
#..#.##.#.##.#.