15 15 0
2 3
6 9
.#....##..#.##.
#.##..####.#.#.
......#...#...#
#...##..##..#..
#.....##..###.#
.##.#....#.###.
.....#....#.#..
.###.#.#.#....#
.##.#......##..
.#.###...##..#.
#.#..####.####.
#.#.#...#..#..#
...#....#####..
......#######.#
.######.......#