15 15 0
8 5
6 5
.######.#..#.#.
.#..###....####
..#.#....#..###
#..#.#.#.##.##.
..##..#..#.###.
######.##.###..
....#.###.##..#
.###..###.#####
.#.##.#..#.#...
.##...#.#..#..#
#...##.#.###.##
####..######..#
#.##.#..##..#..
.#.#.#.########
##...####.#...#