15 15 0
11 3
11 7
..#.#....##..#.
.##...#..##...#
####....#.#..##
###..####.....#
..##..###..####
.#.#...#....###
....##..##.###.
........###.##.
....#..##......
####.#.###.....
.##..#...#.....
..#......#..#..
..##.####.#..#.
..##..#.....###
.##..#.##....#.