15 15 0
5 2
12 5
.#.###..#####.#
.##.###.#.###..
###..##...#..#.
#.#.##..####..#
##....#####.#.#
.....####.#..##
.#.#...####.##.
.#.##.#.####...
##..#.###.#...#
.####.#..###...
.##.#.##..#.###
.#.....#.####.#
###.#.#......##
.....#..##.##.#
#..###.##.....#