15 15 0
11 8
12 1
....#.##.##....
#....####.###..
...####....#...
.##.#..#.#...#.
#####.....#.#..
####...###.##..
#.#...###..#.##
#..#....##...##
#.#....#.##.#..
##....##..###.#
#....#.......##
.#.##.##.##..#.
#.#.#.#..###.##
..#.#..#.....#.
.............##