15 15 0
4 14
5 13
...#.##.###.###
.####.###...#.#
####.......###.
#..######.##...
.#..#.#..#...#.
.#...###.###...
#####.#.##...#.
....#.##.......
.....#..#.....#
.##.#####.#####
.#####.####.##.
##..####..#.###
#...#.#...##...
....#..#####..#
...#####.#.#.#.