15 15 0
4 3
2 3
.#.....#.#.#..#
#.#...#########
###.#.#..##.#..
#.#.##........#
..#...##....###
##..#..#...##.#
..#######.#.#..
#.#.#.###..###.
.....##.###.#..
.###.####..#.#.
#.#.#..#.#..###
##....#.#.#...#
##.#.#.##.#...#
...##.....####.
##...#.##..#...