15 15 0
12 14
11 6
.##.......#....
#..#.##.#......
###...##..#.##.
...##...#..###.
...#.#####..###
#....#.......#.
#.#.....##..#.#
#...#.#..##.#..
#.#.##.###.#..#
##.#.#........#
#......###.####
#...#....#..#.#
.#.#..#.#.#.##.
.#..###...#....
.....#.#.#.##..