15 15 0
3 9
10 0
.##..#.#.#..###
.#........###.#
##.........#..#
#..#..##.....##
##..#.#.#.#....
.#..##.#..#..##
.##..#.#.#..#.#
....##.##..##..
....#####.#....
..###..#.#.#.#.
.##.##.##..#...
.##..#.##.##..#
.##...##.#..##.
.##.#.....####.
..##..#..#....#