15 15 0
14 10
12 9
....####...#...
#.####..###...#
..#...#.#..#.##
...###..#.#.#..
#..........##.#
...######.#.#..
....#......#...
.##.#...####.#.
....#.##.....#.
#.............#
..#.######..##.
..##.#.#.##.#..
.##...........#
..#.##......#..
..#..#..##.#.#.