15 15 0
13 12
5 9
.#.#.#..#..#...
.##..###...#.##
..#......###.#.
#.#.##.#..#..##
.#.#..#........
..#........#.##
..#...#....##..
..####...#..#..
..#.#.#..#.....
.###...#.#.#.#.
..#....#.#...##
....###....##..
..#....#....###
##..#.#..##....
...#.#.##....#.