15 15 0
7 3
0 12
.............#.
#####.##...#...
.....#.#...##..
#..#.##.####..#
.##..###......#
#.#.........#.#
#.#..##...#..#.
#.#...##....#..
.#..#..##....##
#.....##.#.....
#.#..#.##..#...
.####.##....##.
...#.#.##..#.##
##..####.#.#...
..#..#.#.#.#.##