15 15 0
8 5
14 3
#..##.........#
##..##...#.##.#
#.#..#..#..#.#.
.#.##.##....#..
.#...#.#..##...
#.#####...#.#..
#..###..##...##
#......#.#.....
#.....#....#.#.
.#.#.#.....##..
..#..###.######
##.#.###....###
#.#.....#..#...
.##...#########
......#...#....