15 15 0
6 4
5 6
###..#####.#.##
.#.##..####.##.
...#.##.#.#.###
##.#.##.#...##.
.####.###.#..#.
...##..#..#.##.
.###..#..#..###
.#....#..#.##.#
##..##.#..###.#
...##.#.##....#
##...#.###.###.
....#...#.####.
..#.######.#..#
..#.....####..#
##...#..#.##.##