15 15 0
13 11
13 10
##....##.####..
#......##.....#
###.#..###.#...
####..##.####..
.#######..#....
.#...#.#.#.####
.#.#.###.###.#.
.##..#..###.##.
....##.#..#.###
#..###.##.##..#
##.##..###.#.#.
.#..#####.#.#..
..#...#.####.#.
..###..#.......
.#.#....##...##