15 15 0
6 2
4 3
#......##..#.##
##...##.###...#
#.###.##..###..
.....#..####...
..#...#..#.....
#...#..#..##.##
.#...#.##...#.#
.#....#..#.#...
..##...####....
..#.#..##.....#
.....##.##.....
....#..#...#..#
..####.#.##..##
.###.##.#......
....#.#.....#..