15 15 0
5 3
0 9
#.........#.#..
..###.#..#.....
......#..#.....
.#.........#..#
..#...#.#..#.#.
##...###....##.
#..##...#......
.....#.####.#..
#.##....#####..
.####.##...##..
..........#.##.
..###.#..##.#.#
.#....####..##.
...##...#.###.#
#..#.##.#.##..#