15 15 0
13 13
6 1
...###.#.......
...#####......#
..#..#.#.#..#.#
.#...##.#....##
.#.#.#......#..
#....##...###..
#.......##.##..
...#.#.###....#
...##...#..##..
.#.#####.#...#.
....#....#.#.##
#....#.......#.
#..#...###.....
.##.###...###..
.##.#.#.###....