15 15 0
11 9
12 13
.#.#..#.#..##..
.#....#...##..#
#.###..#.......
...######....#.
..###.....#.#..
....#..##.#...#
#.#.##....##...
...#..#...#.#..
#.#....#.......
......###.#...#
#.....#..#.....
##...#....##.#.
#..###..##....#
##..###...#...#
...#.#......#..