15 15 0
0 0
7 6
......#...###.#
#......#..##...
..#.#.#..#..#.#
...##...##.#...
.#.....#..#...#
.#.##.#.#...##.
.##.#....#..#..
..#....#....###
#.#.#.#....#...
##..##......##.
##..#.#.#......
##...##...##.##
...#...#.######
#####....###...
.##..#.....#..#