15 15 0
8 1
9 5
.#..##..#...#.#
...##..#.##..#.
##.###.###..#.#
##.#..######.##
##.#.##..###.##
#.##....#...#..
###..#.#.....##
#.##.#.#.#...##
#.#.#......##..
.......#..#..##
#.#..#.##..#...
.#..#.##...#.#.
#.#.##..#.....#
.#.......#....#
.#.##.###.#...#