15 15 0
11 9
11 13
.#...####.##...
#.######.##.###
#....#..#.#..##
.#######..#####
###.########..#
..#.#.#...#.#.#
...#..##.##.#..
...#..##.#..##.
.##.#.###.#..#.
...#....#..##.#
##.####..#...##
...##.##.......
.##.####..#..#.
.##........#.#.
.#.##.##.#.#..#