15 15 0
10 14
11 13
######..#..#.#.
##....#..#.#..#
............#..
#..#.#..#....##
.#...###..##...
.....#..#..#.#.
..######.####..
......#.##.#.#.
.####.#.....###
..#..##..#.....
....#.......#..
.##..#.###.#...
#............##
.......#.......
....#..#...##..