15 15 0
3 5
10 6
..#.#.###..#.##
##.##..###.####
.#..##.#.#####.
#.#.#..#.....##
###.##.#..##.##
#...##...####.#
.##......######
##...###...##.#
#.#..#.####.#..
.##.####..#..##
#......##.###..
.###.......#.##
#....#.##.#####
...#.#..###....
#.##.##.###..#.