15 15 0
11 3
8 3
...#.#...##...#
..#####.###....
.##.#...#.#.##.
.....####..###.
#......###..##.
#####.....#....
....#..#..#....
.....#...#..#..
.#...#.#....#.#
..#.#.#.##.....
.#...##..#.....
..#.#..####.#.#
....#......##..
##.#.#.........
...###..###...#