15 15 0
5 1
0 8
....#....#.#.##
.#..###....####
##.###.#......#
.###......#..##
#..#.......####
#..#.#..#..#.##
##....#..#.#...
###.#.......###
..#...#.......#
.####.##...#.#.
##..##.#..#####
.##.##..###....
.#.#.##...#.#..
...#.#..##...##
...##.#.##..#.#