15 15 0
13 5
8 1
#.#....##..####
#...#..#.#..#..
..#.#...###..##
#.##....#....#.
.##.#.#.....#..
###..#.##....##
........##....#
#.........#...#
#..###..###..#.
##..###.#.##...
#....#...##...#
#......###.....
#..#...#.##.#..
..#.#....###...
.#..#..#...##..