15 15 0
4 1
3 8
####.#......##.
.#.#.....#....#
..#..#...##..##
..###.##..#..#.
#...####.#.....
..#.###..##..#.
#.#...##..##..#
..##..#.##.#...
...#....#...#..
###......##....
.#.#.#.##.....#
#.##...##.#.#..
##...#......#..
##.#..#....#...
#....#.#.##.#..