15 15 0
4 6
6 8
#.##..#.#..#...
.#.....#...##..
.##..#...#..#.#
.#.#....#.#...#
....##...#.....
..............#
.#.#.#...#.##..
#.#.#.#...#...#
.#.#..####....#
#..#.....##.#..
##.##.##...#...
####...#..#..##
..###....#..#.#
..##..#.......#
....##.#.#...#.