15 15 0
1 5
10 0
##...###..#..#.
#..#..##..###..
.##..#.#.....##
......#.#.##...
...##..#.#....#
#.##...#....#.#
..#....#..#.#..
......##.....#.
........##...#.
..#.##.###..###
........#..##..
....###....####
#...###..#...##
....#..#####..#
...#.####.###..