15 15 0
13 8
11 10
.#.#.#..##.####
#####...#...#..
.#......#..#...
##..#.#.#....#.
...#..#.#.#..##
..#..........#.
#.....#.####..#
.#.#..##.#.#...
.###...#.#.....
#.......#..#..#
.#...#...#.#...
.###..####.##..
..#.#.#.....#..
#......#....#.#
..#####.#..#.#.