15 15 0
7 10
4 12
.#.###.#.#....#
.####....#.##..
#..#..###......
#.#..###.#.#..#
.###...#.....#.
...##......##..
.###..#.#..#...
##.#...........
...##.#..#.#.#.
.####.#####....
##..#.....##...
#..#.#.#.....#.
......#..#...##
####...###..##.
..###.#..#...##