15 15 0
9 4
9 12
###.####.#.....
..###.#.....#.#
..##....###..#.
######.#######.
.##.#.##.##.###
#.#.####.#...#.
.#.#......#.###
##......##...#.
.##.#..........
...#..##.#...#.
...##....##....
#......###.###.
........###.#..
..##...###.#.#.
..#.#...#..#...