15 15 0
11 8
6 10
#...###.###...#
###..#.#.#.##..
..###.###..#...
.#####.#.#...##
..####.#...##..
..###.#.#...#.#
.....#.....#...
.###.###..#.##.
#####.###..####
..#.#.###.#.#.#
.##.#.#....#.##
#######..##..##
#.##.#####.##.#
.###..#.####...
#.##..##..##...