15 15 0
11 11
10 7
#####.#...##.#.
###..###.#.#...
..#...#.##..##.
#.##.##.####...
......#######.#
.##.###..###.#.
#.#.####.###...
#.#####...###..
#.........#.#..
###....#....##.
..##.##..#.#..#
.##.##.........
.##.######...##
...#.##....#...
#..###.##....#.