15 15 0
12 5
11 4
.#.##.#.#...###
#..#######..#.#
##.#.##.###.#..
.#..#.#.#.##...
##.##.#####.##.
#..#..#...####.
#...####.#.####
#######.###....
#...#......#.##
#.######..#..##
#.##...#..#.###
.###.#..#.####.
##..#....#.###.
##..###...##..#
##.....###...#.