15 15 0
13 3
10 6
##.#.#....####.
#.###.####...#.
..#.##..#..####
##.####.#.#.#..
#.#.#..#.###..#
..#.....##..###
##..#.####...##
#.##.#.#.#.####
##.###..#####..
###..##..####.#
..#.##....#####
###.#..##..####
.####...#.#####
.##...#...###..
.#######..#####