15 15 0
3 2
7 9
.#..........##.
.#.#.#.##..###.
#..##...##.##..
.#.....#.#..#.#
..#.#...#.###..
#.#..##.......#
##.#.###.......
#..#..#.#.#..#.
...#.#.....####
#.#...........#
####...#...#...
###.......#..#.
..#..#..###.###
.#....#..#..#.#
#....#..##.#...