10 10 0
6 7
9 5
..###.#.##
.##.#.#.##
...####.##
.#.......#
.##.#....#
#..#.....#
#.....#...
.##.#.....
.......##.
..#.#...##
