15 15 0
2 3
4 3
#..##.#.#.#...#
..#...#..#..#..
###.##.##....##
.#..#..#.#####.
#....##...#.#..
##.####.......#
#.#...#...#..#.
##.##...#.#.#..
##..#.#.#.#..##
.##..#.###.#...
#.#...##......#
.#...#......###
.##.##...#.....
###.#..#....#.#
.......#.....##