15 15 0
9 13
5 7
..####.#...##.#
.##.####..##..#
..##.##.#......
.##.##.####.#.#
..#..##.#..#...
.####.#..#.#.##
..#.##...##.###
#.###.##......#
...##...###.#.#
##..##.##..#..#
#...##.#.#####.
###.##....#.#..
###.#..##......
.########.#.###
###.#.####.#..#