15 15 0
5 11
8 7
.......##.#####
.#..#.##.#.#...
..####.#..#.#..
###.#.#.##.#...
..#.....#.#...#
.#...###.#.....
##.....##..#.##
.......#.#.####
.###.#......##.
..#.####..##.##
#.##....#..#...
#.....##...##..
###.#...##..#.#
##.#.#....##...
####.###....##.