10 10 0
1 3
0 5
#......##.
.##....#.#
#..##.###.
.####..##.
..##...#..
.#..#..#..
...###.###
..#..#...#
...####...
#.....##.#
