15 15 0
7 6
6 6
..##...###...#.
#..#..#.###....
#..#.....##..#.
..####..###.#..
...##.#....##.#
..#.####...##..
.##..#...######
####...#.###..#
#.#.#.#..##...#
..#.#..#...#.#.
#.#.##.#.#.#...
##...#..#..##.#
#.##.###.##.###
#.##.##..###.#.
#..#.##.##.#.##