10 10 0
2 1
0 8
.#.##.##.#
..#......#
.....###..
..#.#.#...
#..#..##..
#..#.#...#
#..##...#.
....##.#.#
..........
...#.#....
