15 15 0
9 10
11 11
#.#.#.#.####.#.
.....#.###..##.
.#.###.##.#...#
.#..#..#.......
......#....####
...#....#..#..#
##.##.....####.
###..#.#.#..##.
.#.##.#...##...
.#......##.##..
..#....#....#.#
.###.........##
#.#.###......#.
.#...##.#..##..
#..##..###.##..