15 15 0
3 5
1 2
#.#.#..#......#
#......#.....##
.#.....#.#.#...
......#.#..##..
###.##.##.#..##
#.##...#..#...#
.....#....#####
.....#..#...##.
##...###..#.##.
##....#..####..
##...#..#..###.
##..##.#..###.#
.#.#####.......
....#..#.#..#..
....#..#.#..##.