15 15 0
1 0
3 6
#.#...#.#......
.#.###.#.##.#..
..#............
..#.##...#..##.
......#.##...##
.....#....##.##
...#.#..##..#..
......##.##..##
.#..#....#.##..
.#.##.#......#.
.....###..#..#.
..#...#.##.#..#
..##....#.#...#
.#..#.####..##.
.##.####.#.#.##