15 15 0
4 0
4 9
.#...........##
.....#...#..#..
.....##.#.##..#
.#............#
...###.#...#..#
.##...#.#.#.##.
##.#.#...#.....
#.#.###.#....#.
##.#.#.....##..
..##...#.#.##..
#.#..####......
....#..##.#..#.
..##.########..
............###
...##...###.#..