15 15 0
1 7
4 14
.#.#......#.###
..#.....#..#.#.
#.#..#.#....###
#.###...##...#.
..###...#####..
##.............
.#.####.#.#...#
..##...#.#.##..
#.####..#......
#...#.#......#.
##....#.#....##
###.......#.#..
.###....#..##.#
#.#......##.#..
.#...#...#.###.