15 15 0
11 6
1 11
##...##.#..##.#
..#.#.#.###.#..
##....##.#....#
..#.###..#.#...
..#.......#..##
..#..###.......
.#.#....###.#..
#.###...###.##.
.#....#....#.##
#....#.#...#..#
.#....#..#..#..
####.....#.##.#
#..#....#.#....
###.##.#.##..#.
.........#..#.#