15 15 0
14 9
13 14
...#.......##..
#..#.#...#..###
#..#..###.####.
#####..##.#...#
.##.#..##.#.##.
#.#.####.####..
#.....###.#.#.#
.#..#..##.#####
#...######..###
###.....#.###..
.#.##..####...#
#...#..#.######
...#...#.....#.
.##..#.........
#...##..#..####