15 15 0
14 6
8 1
####...##.###..
..##.#..##....#
####...##.....#
#.##.#.##....##
###.#.#.###..##
#.#...#.###.###
........#.#.##.
##...#...#..#.#
#..#.#..#.#.#..
##...#.#.#.#...
##.##...#....#.
.###.#...###...
...##..#..#...#
#.#.#.#.#......
.#..#....##.###