15 15 0
8 11
7 9
.####.#..##.#.#
#.##.####..#...
.##..##.####.##
.#...#####....#
.###.##.#..###.
####.#########.
#.####.#....##.
#..######....#.
#.#......#...##
..#.#.###..###.
.########..##..
##.##.#..##.##.
##.#..##.##..##
#.###...##....#
.#.##.###.#.#.#