15 15 0
7 3
10 8
#####.##.#.#..#
#..#####..##.#.
#..#...#...##.#
#.#.........#..
.#...###.###.##
...#..#.#.##.##
##..#.........#
.#..#.#.#.#.#..
##..#..#....#..
.#.......####..
...#.#....#...#
###......#.#...
#..#..##...###.
##.#.#.....####
#...##.##...#.#