15 15 0
4 3
6 1
.#...#######.#.
#.#.#..##...###
.##......###...
#..#######.....
..#.#.....#.#..
.##.##..##....#
......#.#...#.#
#..#..##.#..#.#
.#...###...#.##
#.#.####.#..#..
##.##..#..##..#
####..#...#..##
#.###..##.#.###
#..##.#.#....#.
.#.###..#......