15 15 0
4 8
3 8
##.#..#####.###
.##...#....####
##.#..##.######
.###..##.####..
#..#.###.#.####
..#.###.##.....
.#.###.####..##
##..###.###.#.#
.####.#.###.##.
##..#####.#...#
###.#..#.##.##.
#.#..###.####..
#....####.#..#.
...##.##.....##
...####......#.