10 10 0
2 6
2 4
...##.#...
.##..#.###
........#.
#...#.##.#
####....##
.#...#..#.
##..######
...#####.#
#.#####.##
#.###...#.
