15 15 0
2 11
9 2
#.#.###.###...#
#.#.#......#.##
..#..........##
####....####...
.#..#.#..#.....
...##.#..##...#
#....##.#.#####
#..#.......###.
#######.##...#.
......##.#.....
#.##....#.##.#.
#.##...........
.#..#.#.......#
...#######.#...
###.#.#.......#