15 15 0
6 13
2 14
.#.#.#.....#.#.
...##.#.#..#...
###.#..###...#.
.##.....####..#
...##......#...
..#.####.##.#..
#..#.##.#..##..
#..##...#...##.
..#.#.#.#.##...
#......##..#..#
...#.#####....#
##..##.#.##....
.#..#....##.#.#
#.###.#...##..#
...####..#.##..