15 15 0
5 13
0 5
...##......##..
##..#..###.....
##.##..#..####.
#####.##.#.#...
#.#.##.#..#..#.
.####.#.#......
.##..#.###.##.#
###..#.....#.##
...##.#.##...#.
.....#.#.###.#.
#......#..#.##.
#####.#.##..#..
.#.####..#...#.
.....###.#..#.#
..####.#.#####.