15 15 0
8 8
8 12
.#..##.###.#...
.##..###.#.....
.###...#..##..#
#.#.#..#...##..
..##.##.#...#.#
##..#...#...###
.#....##.#.#...
#.#.#......##..
#.####...#.....
..#..#.###...##
.#.#..####.####
#....#.####.###
.#...##........
##.#.###....##.
.....#..##..##.