15 15 0
4 13
12 5
...##..#..#..#.
##..#####.#....
.#.#.##.##.#..#
##..###.##.#...
####..#...#...#
..##.#.####.#.#
##..#.##.#..#..
..##.....##..#.
.#...#.#.#.##..
..#.....#....#.
#.........#..#.
...#.#...###.#.
......#.#.##...
#......#...#..#
.##..##..#.....