15 15 0
7 5
6 3
###..#.##.####.
###.#.###.#####
#...##.##...###
#############.#
#..############
.#...####....#.
###.##.###.####
##....#..#####.
##..######.#.#.
#######.#..###.
##..##...#.#..#
##.###.###.#.##
#..#.####.###..
.##.###.#####..
..#.####..###..