15 15 0
4 6
1 9
#.##..##.#.#.#.
#....###....##.
#......#..##.#.
##.#..##.#...##
######...##.#..
####..########.
###..#.###....#
#..#..##.#####.
###.##.#..#####
.###.##########
.########.####.
###...######.##
#.############.
##.#.#.#.##.##.
..######....###