20 20 0
18 8
15 19
##....#.##...#......
###...#.#.#....#####
.##..#..##.###..#.##
#...#.....##......#.
..#....#..#.#...#.##
##.###.#.##.......#.
....####..##.###...#
.....#.#####.##.#..#
...###..#.#.....#...
...##......#..#.....
..##.#..#.##....##..
....#.#...#..#.#.#.#
..#..##.#..#..#.##..
#..#...###......#..#
.....#.#...#..##....
...#....#.#..#...##.
.####..#.####..##...
#..#..##....#......#
#.........#...#.#.##
.#.#.......#..#..##.