15 15 0
6 6
11 6
.##.#.#....####
.#..##..#######
#.##....#.#.#.#
.#......#.#..##
#.#.....###..#.
..#..#...#....#
#..#.#..#.#..#.
#....#...######
.##...#.##....#
..##.#....##..#
.#..##.#.....#.
.....#.#..####.
#..#.#....##.#.
....##.####..#.
##.#.#.##.#..##