15 15 0
2 12
2 6
.#..#...#.#....
#.####.##.#...#
#..###........#
.####.#..#.....
....##.#####..#
##.#..#.......#
..#.#....#.##..
.##...##....##.
#.....###..##.#
.#..##..#.##..#
#..##....#.....
.###.#..#.#..##
#.....#..##.##.
...#.....#.#.#.
#..##.....###.#