15 15 0
10 2
5 10
.#.....###...##
.##..###.##...#
.#...##..##.#.#
.....###....##.
#....#.###.#...
#.#..##..#...##
............#.#
##.#.###.######
.#.#....#....##
##.###....###..
.#..#.....###.#
##....###.#....
........##..#..
.##....###...#.
#...#.####..##.