15 15 0
9 12
8 12
.###...#.##.#.#
#...#.#......##
...#...##..###.
.##.#...#.#####
###.#.#..####.#
##....##..#...#
.##...#..#.....
.......#..#....
#.####.#.#...##
#....##...#....
#.#..#.#.###.#.
..#....##..#.#.
#...#####..###.
..####.#..#....
#.###..##..#...