15 15 0
5 10
1 7
..#.#..##.####.
####.#...#.#..#
..#.##.#..#..#.
###......#...##
#.#...........#
#.##.....#..##.
#.#...#.......#
.#...#..#.##..#
..#..##.####..#
..#....#..#####
#.#.#.#..##....
#..#.#..##..#..
##.###..###.###
..#..#..#..#.#.
.#.#..#...####.