15 15 0
5 2
13 1
...#.####......
.#.##..#......#
..#.#..#.###.##
........#...#..
.#.##..###.#..#
.......#.###..#
##.##.#####...#
#.#.......##.##
..##.#.#.#..#..
#..#...#.######
..###....#.....
......#...#..#.
..##.#.#.##.#..
.......#.#..#.#
#####...###.#.#