15 15 0
12 13
12 14
##...#..###.##.
#.#.#####..##.#
#.##..###.#.###
#.####.#.###.##
#.#..#.#.##.#.#
.###.#.##...#.#
####..###.###..
.#.##.#.#####.#
###.##.#.###...
.###...####...#
.#.#.##.#.#...#
#.#..#.########
.#.#.#.....##..
.#.#.#.##.#.#.#
.#...###..#..##