15 15 0
9 5
2 12
.#...#.....#...
###.#...#..#..#
.##.##..##.....
.#....#......#.
.#####.#.#..##.
#.#.....##..#..
...###.....#...
.####.#...###..
.#.#.##....#...
...##..#....#..
##.....###...##
....#..#...##.#
#..#.###....###
#.#.......#....
.......#..###..