15 15 0
13 2
14 0
#.#.###.#.....#
.#.#..#.#..#..#
.#...#.........
....#.#.#.#.###
....#.#.#.###..
..##.##...##..#
.#.#.#..#####.#
###......#.#.#.
.#..###........
.#.#.#.##.#####
..#......#..###
#.#.##.##..#...
..####.##.#....
##..##.#...#..#
......#..##..##