15 15 0
8 6
11 10
#.#..........##
...#.#.........
##.#..##.##..##
###..##..#...#.
.#.#.....#..#..
..#...#..##.#..
....###.##..##.
...####..#....#
..##...##..#...
.##..#...##..##
......###..#.##
#.##.......##..
#.#.....##.###.
.#...........#.
...#...#.#.#.#.