15 15 0
5 4
4 6
.####....#####.
.##.#.#...#...#
#....##..#.##.#
##..##.##..#...
##.#.#..#.###..
.##....#.#.###.
.#..#.......##.
#..#...#......#
#.#.#.#.#.#.#.#
..#.#...#......
#.##.#...###...
..#.#....#####.
###.#...#.#.#..
#..#...#.#.....
....#.#.......#