15 15 0
8 0
10 8
#.#.#...#.#.#..
......##.###.#.
###.#..#...###.
#.#..#..#...#..
....##.#...#..#
....#...#..#.##
.#...#..####..#
.###.####.#...#
....#..##.##..#
#......#.#..###
#####.....#...#
.#.#..#.#.....#
.....#...#.##..
.#...######.#..
#..##.#.#...#..