15 15 0
9 12
9 14
...#.#.......##
...#.#.#...#.##
####...###.##.#
##..#..##.##..#
..##..#..##....
#.#...#####....
####..##..###..
.#.#....#.#..#.
.###......###..
..#.#.##.##....
...#..#.....#.#
.####.#..###...
#...##...#.#...
#..#.####...#.#
#.####...#.#.#.