15 15 0
6 4
10 3
###..###.##.#..
#####..###..#.#
.##....#.######
...#######..##.
..#####.###....
##..#.#####....
##.#..###.....#
#.....##...####
###.#..#.###..#
.....##.###.###
..#.##.#.#.###.
.###.########..
.#...#######.##
.....#..#.##.##
.#.#.....#..###