15 15 0
6 8
9 7
#.#...#.....###
..##.#.......#.
.##.##...#.....
.#.#.#.#....###
...#.#.#.#..##.
..#.....##.##..
#..###...#.####
..#...#....#.#.
..#.#..#...#.#.
..##.......#.#.
.####..#...##.#
##.....#.#..##.
#....#....##..#
.#........#..##
...#.##......##