15 15 0
0 10
1 11
##..#.##...#.##
#.###..#......#
#.....#.#......
...##..##.#.##.
###.#..#..#....
.#.#.#.####.#..
#.##.##.##.####
.###.#...##.##.
.####...#..#.#.
###..#.#.#..##.
#.###..#.#.....
######.##.##...
...#....#.#..#.
#..##..#..#.#..
.##..###.......