15 15 0
14 8
13 9
..#....##.....#
.###.#####..#..
##.#.##..##.#.#
.#.###.#.####.#
##.###.##...###
###.....#.#####
#...#.##...##..
.##.####.##.###
####..#..######
#..###.####....
...#..#.#......
#.#####.##.....
#.#....#######.
.#.#.#.#...###.
###.###....#.##