15 15 0
11 8
13 13
.#.###.##.###..
##...#######...
##...##.#....#.
.#..#....#...#.
##.##..########
.###.#..####.#.
###..#####.####
#..#...#.....##
##.#.#.#.#.###.
#.#######..###.
##..##.###.##.#
..#....#.....##
.#...#####...##
.#..####..##...
.##..##..#.####