15 15 0
5 12
4 10
.#.####....#...
.#####.....#.#.
####...#....##.
..##........#.#
##.#.#...#...#.
.##....##......
..#.#.#..##.#..
#.##...###.#..#
#.#.....##.##..
####.#...#..#.#
##..######..#..
....#..##...##.
#....#.##..#..#
.#.##.#.##.#.#.
.....##.##.#.#.