15 15 0
12 7
14 8
..##.#....###..
####...####.#..
#.#.#.....#..##
.#..###.##.....
..###.#.....#..
.##.###..#.#...
##.#.##.##.#...
#.....##.#..##.
###.##.#..#.##.
##.##.##...#.#.
#.###......#..#
...##..#####..#
######..###.#.#
...#.#..#..##..
..#.##....##..#