15 15 0
10 14
1 14
#.....#.#.#...#
#..#.#....#.##.
......##..#..#.
...#.##.....#..
.#..#...#####..
##..#.....#....
.###...####.#.#
.....##..##....
..#......###...
#.##...##.##...
#.##...###.#...
##.#.####.##.#.
.#...#..##.#.##
#.##..#...##...
...###..##.....