15 15 0
5 4
5 11
..#....###..#..
##.......#####.
#..#...#.....##
##..#....###.#.
...#..#....#...
.#.....#....##.
.#.###..#######
###.....#.#..#.
#####...##..#.#
#..#..#.##.#.##
#....###......#
#.....####.#.#.
.#.#.#..##.#.#.
....##.#####...
....#..##.#.#..