15 15 0
11 10
10 3
.#...#.###...#.
..###.#.###.#.#
##.#...........
#.#..##..#....#
#.##....#..###.
.#.#...#.#...##
..#...#...#....
.#.#.....#..#..
#.###...##.#...
.#.####...##...
##..###.#..####
##....#..#.##..
#.......##.##.#
...###.#.....#.
###....##.....#