15 15 0
7 10
8 7
##........##...
.#.#..###......
#.#.##...###..#
.............##
#......#.##.#..
###..##..#...##
.##.#...#....##
...##...##.##.#
......#.#......
.##..####..#...
###.#..##.#...#
.#.#.#.#.#....#
..###..#.##.#.#
.##..#..#.....#
...#...#..#...#