15 15 0
5 7
7 11
#.#.##.###..##.
#####.#.######.
#####....##.#..
####.##.#.#..##
##.#....#####.#
...#.#....#.###
########..#####
..#.#.###.....#
#.#.#####..##.#
.#.###.#.#..###
#....######.###
.##.##.##.#####
##.#.###..###.#
#.###.###..#.##
#.#.#.##..##...