10 10 0
4 2
1 2
.###..#.#.
.#......#.
.#...##.##
#..#.##.##
.#.#.##.#.
##.#.#####
...##.#.##
...#......
.#..##..#.
#..#.##.#.
