15 15 0
6 7
11 4
#.##.##..#....#
#............#.
.......#.####.#
#.#....#.#.#.#.
....#.#...#.##.
##...####...#.#
..####..##....#
#........#.##.#
#.#..#.#####...
.#..#......##..
.....#..#.#..#.
#.#...#..#.##..
.#.##..##.#.#.#
.#..#.##.#..###
#.#.#...#.#.#.#