15 15 0
12 12
13 13
.#..#..........
...#####....###
#.....##.##....
....#..#..#.#.#
.#....##.......
#.##..#....#..#
.#.#....#.##...
..###.#######.#
##...##.###....
#.##...#.##.#..
#...###......##
.#####.##.####.
##.......##..#.
##..#.##..#....
#....#..#...###