15 15 0
6 12
13 12
..#.##.###.....
.#..####.######
..##.#.#..####.
#...#..###.#.##
.#..#....##..##
###..#..#..####
..#..#....#..#.
.#####.#..#...#
..##.#..#......
.##..##......##
.##..#...#.#...
##.###..#......
#...#..###.....
...##......#.#.
.#..###......##