15 15 0
5 2
4 3
..###.#.....##.
....#....##....
##..#.###.###..
..####...#..#..
###...#.##..#..
.#...#..#.####.
.#####..#....##
####.####.#..##
.###.##.#...###
..###...#...###
#..#.#.####.###
.....#.###...##
..##...#.#.##.#
##...#.....#...
##.###.#....#.#