15 15 0
8 9
8 6
.####.###.#.###
##.###.#.######
...#.#.###.##.#
#.#.####...####
..#.#######.###
.##.#.#.#####.#
#.###.#.#...###
...##.##.#...##
##.#......#...#
.#.##.....##.#.
#.#...#.#..##..
##.##..#....#.#
......###.####.
#.#.#.#.##.#.#.
......#####...#