15 15 0
6 13
12 10
###.#.####.###.
#..###..##.#.##
...#####...##.#
#...###..##.###
#.#...#.##..##.
...######.#...#
.#..#.#.#...#..
###...#...#..##
..#.#...##..#.#
##.##.#####...#
..#..##.###.###
.####...#......
#....#.#.#....#
##.##.##.#.#.#.
#...######.#.#.