15 15 0
11 13
11 10
.####..#..#..##
...##......###.
.#...#.#.###..#
##....#.##.####
...##.#..#####.
.#.#.#..####...
.#.....#..#..##
.##.#....##....
.##..#..##..##.
#.#.##...#..#..
#.#.....#..#..#
#...###.......#
.##..##.##..#.#
#...##.#...##.#
.#####.#..#.###