15 15 0
8 4
9 3
##.#...#...#.#.
.#####..####.##
.#...#.###.#.#.
#..###.#.#...##
...#..#.###....
##.######.#.###
##.###..##....#
#.#...##.#.#..#
.......#..#####
###....#####..#
#####.#..#####.
#..#..###.###.#
#.###..####.##.
#...#.#.#..###.
#..#.###.#....#