15 15 0
11 11
14 13
###.....#.###.#
...#..####..###
.##..###.#.##..
..##.....#..###
#.#..#.##..##..
.###.##..##..##
#.#.########.##
.###.....###..#
..##.##.##.#.##
#..###.#.##..#.
#.#.#.##...###.
#..####.#....#.
#..##.#....#.#.
..#..#.###...#.
####.#..##.....