15 15 0
1 1
2 0
......##.....##
#.#..#..###.##.
....####..###.#
.#...##..####..
....#...#####.#
...#.#.#...#..#
...###...##.##.
#..#.#.#.##..##
##...#..###.##.
##..#######..##
...##..##.#####
.#...##.##.#.#.
####.....#.....
####.#...######
#.#####.......#