15 15 0
4 8
14 11
.#.#.###..#.#.#
.##.#.#..##.#.#
#...#..#.#..###
.#..###.##.#.#.
..####.....##.#
.#.###...#.###.
#..#.#.#..#....
..#####..#.....
#.##.#....#.###
.#..#...#.....#
##.##...#.#..##
..#..###....#..
..###........#.
...##..##.#.#.#
.###.....##.###