15 15 0
6 11
1 10
......#####..##
....#...##.##.#
....#.#....##..
..........#.###
...#.###..#..#.
.###.#..#..#..#
##...........#.
#..#...#.##..#.
###....#.###.#.
###...#...#.##.
#....###.......
....#.#..#.....
.#..##...#.##.#
...##........##
.#.#.##..##.##.