15 15 0
11 6
7 12
..#...##.##....
#.#.#######...#
..#.#.#.##..#.#
####..##.##.###
.#..#.#.#.##.##
...#.##...#####
.###..#.##....#
.##.#..#......#
....###...#.#..
......#...####.
..#..#..#...#..
#..#.#....##.#.
.#...#.###..#.#
..........#....
....#.#......##