15 15 0
7 14
8 12
.###.##.#..#.##
#.##...#.#.....
..##..#..##.#.#
#.#..###.#..#.#
#..#####..#.#..
##.#.#.#...##.#
#.########.##.#
..##.##..#..#..
.####.....##..#
..####..#..##..
##...###.###..#
.....#..#.#..##
####.##.#..##.#
.#..#.#.#..#..#
.######......#.