15 15 0
8 7
9 6
..###.##.#...#.
###..#.#.#.#...
#...#...#.#.#..
..#.......#..##
.##.##.........
#####.........#
...........##.#
###.....##...##
...#..#.#.####.
#..#...#.#.#..#
##.....#.#..#.#
##.#..##.#.#...
..#.#.#.#..#...
#.#.##.#.#...#.
..#.##..#.#####