15 15 0
3 7
1 6
####...##..#..#
#.##.#..#####..
#.#.##.....##..
##...#...####..
##..#...#######
.###.#.##.##.#.
.....###.#.##.#
#..#..#######..
.#..##..##.##.#
#......##.#..#.
#.#.##...#.#..#
..#...#.#..#.#.
#.........#..##
##....##.#####.
#..##.#.#..##.#