15 15 0
8 6
9 13
######.##...###
.#######....#..
..#...######.#.
###.##..#.#...#
.##...#..####..
#..#.##.######.
..##...#.###.#.
####.....##.##.
...#.#..#....##
..#.......##...
.##.##...##.#.#
.##..#.####.#.#
.######..##.##.
#####...#.#####
#.###.##..#.#.#