15 15 0
8 6
3 12
..####.#...#...
..#..##.######.
##.#.##.....#.#
#.#.##.#.#.#..#
.#######.#...#.
...#...#.######
.##....#...####
.#.#...#..###.#
##..#....#.#.#.
##..#..#....##.
###..##.###.#..
.....#####..##.
#...##..#..#.#.
#####....#.#.#.
.###.#...#..#.#