15 15 0
4 11
7 4
.###..#######.#
#...###.##.##..
####.#.########
####.#######.##
.##...##.#....#
#....#.###..#..
###..........#.
.#....##.##.#..
##..#..###..#.#
#.###.#..#.####
##.########.##.
#.###..#....###
#...##.#.#.....
.#####.#######.
......###..####