15 15 0
0 8
2 4
.#..........##.
#....#..#..#...
###....##.#.##.
.##..#.#..#.##.
...#.......##..
##.##.#.####..#
..#...#..###.#.
.#...#####..##.
#.#....##...###
#.#.#.##.##.#.#
.##.######.#.#.
..###.##.###..#
#####...#..#..#
#...#####.#.#..
.#.#.##########