15 15 0
3 10
11 1
....#..#..##.#.
...#..###...##.
#.#...#.#.###..
#...#.......#..
#..#...###.....
##.#..#.....#..
#..#.....#..##.
..###...#.....#
.......##..##..
#.###...#....##
...##...#....##
#.#.#.###..#...
......##..#...#
.#.#....###...#
.#.##.##...##.#