15 15 0
5 6
8 2
.#..#####...###
#.##.#########.
######.##.#.#.#
##..##......#.#
.#..#..#.######
.#.#...###.##.#
#.#.#....#.#...
.###..####.##..
#....###.####.#
##..#...##.#...
###.###..##..##
.#####...#.#..#
.####.###.##.##
#.#.####.######
###....######.#