15 15 0
3 8
11 9
###...#.#..#..#
#.##....#.####.
...###.####.###
#...##.....##.#
##....##.#..##.
..#....#....##.
.#........#..##
..##.###...##..
.##......#.#...
#.###..##.###..
..#.##.#.##....
.#..##.......#.
#.##..##.#.#.#.
...#...##...##.
...#.#...##.#..