15 15 0
9 6
14 1
..#....###...##
##...#.#..#..#.
#....#.##.#.#..
.#....#....#.#.
...####.#####..
..#.##.##.##..#
##.#.#..#####.#
###.##.##.#..#.
#.#.#.##..#..#.
.......#......#
##...#.#.##....
.....##...##.#.
.#..#...###.##.
..####.#.#..###
..#.##.#...#..#