15 15 0
7 10
6 3
......######.#.
.##....#.#..##.
....####..##...
.#..###.###.#..
#.#..#.......#.
##.#...#..###.#
#.........##...
.#.#.####..##..
..###.#.##.###.
.......#.######
...#.####...##.
.#.##....###...
....#.##.##.#..
##..#.#..#.##.#
.###.#.#.##..##