15 15 0
14 10
11 10
..##.#..#..###.
#.....###.#..#.
..###.##.##..#.
#...##.....#..#
.####...##..##.
#.##.##...#.#..
#..##.##.###..#
.##...######...
##..#..##..#.#.
.##..#.#..##...
###.##.##.#..#.
..####...#...#.
...###..#...#..
..#.#.....#.##.
##....###...#.#