15 15 0
11 4
12 10
..#.....###..#.
#######.#...#.#
#..#.#.##...###
..##.#...##.#..
.#.#.###..#.#..
#.##...#.#...#.
.#...#..#.#.###
#.###.#....#...
...######.#.##.
###....#.###..#
##.##....##....
..#.....###....
.#..##.....#.#.
#.......#.##.##
#..######.#..##