15 15 0
11 12
9 8
##.###.###..#..
....##....#.#..
.#...####.#####
..#.....##...##
.###.#...###...
#.###.##..###..
###.###....#.##
.#.##...#.#....
.#####.#.....##
.#.##.#..##...#
#.##...##......
.#.####...##...
....#....#....#
####...##..##..
.......##..###.