15 15 0
5 8
9 14
#..###...##.#.#
#..#...#.#.#.##
.#..##..##..##.
.####...#.##.##
#.##....##.#.##
#.#..#.#.#..###
#.....#..##..##
...#.#..##..##.
.##.###..###.#.
....#..#..#.#..
.........#....#
###...#...#.###
..#.##....#....
.#...#.#....#..
##..#..##...##.