15 15 0
10 8
11 10
..#####.###..#.
####.....##.##.
#....###.......
..#....##.#....
.#.###.....###.
#.#..###.#...##
.##...#.#......
#....#.....##.#
..##.##.#.####.
.##..##...#..#.
#...#.....##.##
.########..#.##
.#..##..#.#...#
...##..#.##.#..
##....#.#.#....