15 15 0
9 9
3 12
..#...#.#...#..
.##..###.##...#
..###...###....
.#..#.#.#......
##.#.#..#......
###.##.##....##
##..##.#..#....
##.#...#...#.##
..#..#..##..#..
..#.##.........
####.#...#....#
#..#.......#...
.##....#......#
......#....#.#.
#.###..#.##.##.