15 15 0
10 10
8 7
.#...###.##.###
###.##.#...#..#
..#.....#..##..
....#..#...####
##..#..#..#.#.#
....#..###..##.
.###.##.##.#.##
..##....#.#.#..
#..#........##.
##.#.###..##.#.
.###.#..#...###
#..#...#.###.#.
#.#.##.##..#.##
#####..#....#..
#.#.#.#.#.#.#.#