15 15 0
6 10
2 11
#.#..#.....#.##
#.##....#...#.#
....#..##...##.
..#.#....##..##
.####...#..##..
##.##.#..#.....
##.#.##.#...#..
#...#.#....#...
#...#..##..####
.#..#.#.###...#
...####..#.#..#
.#..##..##.#.#.
.....#####.###.
.......#.#.#...
...#..#.#....##