15 15 0
13 0
12 4
##....#....#.##
.###..#.#.##..#
.##.##.#..###.#
...##.....#.##.
##.#..###..##.#
####..###.##...
..##.......###.
.#.#.#......#..
.##.#.##.#...#.
#....#.##..##.#
..##......##.##
.####....####.#
.....#.....#...
.#####..#..##.#
..##.#..#...#.#