15 15 0
4 7
2 13
##.....#....###
#.#.....#..###.
.##..##........
.#.###..#.#..#.
...#.##..#.###.
.....#.##.#....
#...##.#.###.#.
.......###...##
.##..#.#...#.#.
#...#...##..###
.###...#....#..
...###....#....
..##...#..#.##.
##.......##...#
#.#..##........