15 15 0
12 12
14 5
#.#####.#...#.#
#.###..##.....#
.#.#####.##..#.
.###.#..#.##...
.####..#...#...
.#....#..#.#..#
..##...##...###
###.##.##...##.
##.#...#..###..
.#.#...##..#.##
.....#...##.#.#
#....##.####..#
##..##.####....
.#..#...#...##.
.#.#......###.#