15 15 0
5 1
5 10
#...#.####.#.##
#..#.###.#...##
.#.##.###..#.#.
##.#.##.#...#..
..##.##..#..##.
...#.##.#..####
...#...#...#...
##...####.#..#.
#.##..###..##..
.#.........####
..#.......#.#..
##.#.##....###.
.#.....#..##...
.......#.#.#...
##..#..#...#...