15 15 0
7 11
3 11
.#.#....###....
..###..........
.#..#..##....##
##.#..#...#....
##.#...##..#...
####...#...#...
...#...#.##....
..###.##..#....
#.#.#....#.##..
.#.#.#...####..
..#..#...####.#
.###..#....##..
#.##...#..#.##.
..####..#.#..#.
...###.#...###.