15 15 0
4 8
8 7
.###.##....#...
.#.......#...##
.#..#..#.#.#...
...##..##....#.
#.#....#...##.#
.#...#..#......
..##...#......#
....##..#.#.#..
#...#.#...#####
..###..#.#.....
..##...##..#.#.
#.##....#..#...
.......##.#..#.
####..#####....
#....##....##..