15 15 0
4 0
5 3
##.######.##...
.#..##.#.....#.
.##...#..#.#.##
...##.#.##..#.#
....####..#.##.
.#...#..#.#.##.
##.#..####...##
#..#.####.#..##
.#.#.#.#....##.
...###..##...##
.............##
###...###.#..##
..##...#..#..#.
#........##.#.#
..#.....###....