15 15 0
0 10
3 0
#..#........#.#
###..##....###.
.......#.###..#
..#...##.####..
....##...###..#
..####.###.##..
#..##.#..##...#
...#.#.####..##
....##.###..#.#
.#.#.#......#..
..#.##.##.###..
##.#.###.###...
#.##.#..#.#....
...#.#...#.#.#.
....###.##.####