15 15 0
1 9
2 10
#.#...########.
#.###.###...###
######.#....#.#
#.#####...#####
..#...#...##.##
####..#.###.#..
##.#####.....##
.###.##.#.#####
#..######.##.#.
.#..#..####.##.
....#...###....
#####..#.##..##
..##.##...##..#
.#.#####..#.#.#
#....#...#.#...