15 15 0
10 4
5 0
...#..#.##.###.
##...##.#..#.##
.....####..##..
...#.##.##.#...
...#.#..#..#...
..##...#....#.#
#....##..##...#
.#...#.####..##
....##.##.....#
#...##.#..####.
#.##....##..##.
#....#.#.#..#..
.#.....#..#.#.#
...#.#...#.####
..#..######.#.#