15 15 0
7 7
14 13
#........##....
...#.###..#.###
.###...##..##..
####...#...##.#
##.#.........#.
.##.###....##..
.#.###.#.##.#..
#..####.....#.#
#...#...#...##.
#...#.###.#...#
......#..#.#...
#....##..#.#.#.
.#.....#.##...#
##.#..####..#.#
##.#.#..###.#..