15 15 0
6 0
7 0
#..#..#..###...
#...####...#.#.
#....#...###...
..####..#.#..#.
.####...#.....#
.#.#....##.....
.#..#######.##.
.#....#...##.##
#........#.#.#.
.#.##.......#.#
..#..###.###..#
..######.#.#..#
#####.....#.###
.###.##.##.##.#
....#.#...#.#..