15 15 0
7 5
7 3
#...###.####..#
.##...#...#.#..
...##.###..#...
#..##.##.#####.
.##..##.##.##..
#.#.#.##..#...#
.###..###..##.#
###.....##...##
.###.#.#..#.#.#
.##..########..
#..##...##.##.#
.##.#.####..#.#
..####...####..
##........#....
.######...#...#