15 15 0
7 8
2 5
..#.#..##.#....
#.....#.##....#
#...#.#.#...#..
.#....##.##..#.
#...###..#..#.#
#.....#..##....
...#.....#.##.#
.##.##.#.##.###
#..####..###..#
.#.#.....##....
..###.##.......
#....#.##.#..#.
..#..##.#..#.#.
#.#.#.#.#####..
.#......#.#...#