15 15 0
12 11
7 7
.#..##..#.#..#.
###.##.#.#...##
..#.#####.....#
#..##..####...#
#...##.##...#..
#####....##..#.
.....#...#.####
###...#.##.##.#
.#.#.#..####.##
#..##..########
.###....#...###
.##.#.#..###...
####.#.#....###
...#...#####.#.
#...#..#####...