15 15 0
11 5
0 5
.#....#.#.#...#
.#.##...#....##
..#...#.####...
.##..##.#...###
....###.....#..
##.#.##.##.##.#
.#.####.....##.
.##...##.#.##..
#.##..##.#....#
#.#...#..######
#...#....#...##
#.###.##...####
...#..#.##.#.#.
....#..#.##.##.
..###...#####.#