15 15 0
5 6
7 4
####....###.#.#
##.##..#.#.###.
###.##.###....#
###.##.####.#..
##.######.#.###
..###..#.####..
##....#########
###..#####.#..#
.##.###..#.####
.#####.###...#.
#.#######.....#
.#..###.##...#.
#.###.#....#...
#.#.#.###.#.#.#
#.##.###.###...