15 15 0
9 10
14 5
###......##..#.
.##..#.#.#.###.
...##..##...#..
.....#..#...##.
....#..##...#.#
##..#.....#####
..#....#.#..#..
#..##.##....###
..#....#..##...
.......##...##.
...#.#.####...#
...##..##....#.
..#..........##
#..#..##.#.###.
#####.##.#..###