15 15 0
13 12
12 2
.##.#.####...##
##..#.##...###.
##..##.####.#.#
####..#.#.#.###
.#..######.#.##
.##.##..#.#..##
###.####..#####
########....###
#.#..##..##...#
.##.##..##....#
..##.#.#.......
........####.##
......#.#..#..#
#...#..##.#..##
##.###...#...#.