15 15 0
7 4
10 0
.##.##.......##
....#.#.#..####
.##...#..####..
###..##.#######
#.##....###...#
#..###.##.....#
.###.##....##..
#.##.####...###
.....###.......
#.##.#..#..##.#
......##.#..###
.#..#.###..##..
#####.##.##..#.
...###....#..#.
.#.##.....#....