15 15 0
13 10
12 1
...###..#.##...
##...#.#.##.#.#
##.....##.#..#.
.##.#.##.#...#.
....#.###.#.#.#
...###.#.#.#.#.
....###.#.#...#
..#.#.####..#.#
...##.#####..##
##....#..#.##.#
#...##..#...#..
####...##..#.#.
#..#......#....
.....##.#..##..
.......##...##.