15 15 0
10 2
6 5
.#...#.##..###.
..#.....##.#.#.
####.#.####.#.#
####......#..#.
#..#.#######.#.
..#.###...###..
#####...##...##
#####..#.......
#.####.##.#.##.
#..###..##.#.#.
........##...#.
#..#..##.....##
....##.#..#....
.#..#.####.#.##
..###.#..#..#..