15 15 0
10 14
9 6
.....#...#.##..
..#.#.#.#.###..
..##.###...###.
#..##.##.#.#.#.
#...##..#..#.#.
#....###.#.####
.##.........#.#
..#....###...#.
.......#....###
.##......#####.
##..#...###.#..
..####....#....
####...##...#..
.#...#..##...#.
...####..##...#