15 15 0
10 6
8 7
##.#....#..#...
##..###.#.##.##
..#..#....#####
..#..##.....###
#...#...##..###
##.##....######
.#..###..#.##..
.#..####.#.#.##
###.#...##..###
#####.#....##.#
.###.#..#...#.#
##...##.###.#.#
#######.....##.
##.#.##.#...##.
.#.#.##..##.###