15 15 0
10 10
12 8
#.###.##.#..##.
.#...##..#.###.
.#..#...##.##..
###..#...#.....
.....#..##.#..#
.#..#....##.##.
...#...#..###..
...#....####...
####.#.###.####
.#.###..##.....
....#.......#.#
##....#..###.##
##.#.....##.###
#.#....#....#..
###...#.#.#.#..