15 15 0
12 4
2 3
##.###.#.####..
#.#.#.###.#.###
.#..##.#.#.#.##
#.......#.#.###
####.#.....####
#######.#######
.#..##..#.##...
#......#.#.##..
#.#.#...#..####
####..###..#..#
...#.......##..
....#.#.##...##
##.#..####.....
.#..##.##.##.##
.#..#.###.#.#.#