15 15 0
1 7
2 10
#.#...#..#...#.
.#.........#...
...........#...
...#...##.#...#
#..##.#........
....##.......#.
..#.....#...#..
...#.#.#..##..#
.#..#......#.#.
##...##.#...#.#
..#.....#....#.
...##.###..#...
.#..#.....###..
#...#...#..#.##
#.#..##.....#..