15 15 0
13 6
11 6
#...#.#.#.###.#
###.#....##....
.##.#...##..#..
#...###.#..#...
..##.#.##..#..#
##.#######...##
.#.##...##.###.
.####.###.##..#
#..###.#.##.#..
#####.#####....
#..#..####....#
##.#.#..##.####
.#..###.#.##...
#..#.#...#.#.#.
.#....#.#.#..##