15 15 0
5 4
3 11
..##..##.###..#
##..##....#....
##..####......#
.#.#..#.##....#
..###.#.#.#....
##.....#.##..#.
.#....#..#.##..
...##..#.#.##..
.#.............
#...###..###...
..#.....##...#.
#.#.#.#.#....##
.###...#.###...
...#...#####...
.....#......#..