15 15 0
12 10
10 9
...#.###.#.##..
.#.#..#.###..##
.#.##.#...###..
#..#...#######.
###..#.#..##.#.
.#.#...#...##.#
##.#..###...#.#
##....#.#..#.#.
##...##.######.
#####..#.#.####
..#....##...###
#..#######.#..#
###.##..##.#...
#.#.#.#.#..####
###.###.#...#.#