15 15 0
0 7
3 10
##.####.#.##...
...#........###
.######.##.#...
##.#..#.#..###.
########.###.##
###.#.###.#.#.#
.####.#.######.
#...###.##..#.#
###.#.#.#....##
#######.#.###..
#.###..####.##.
..##.#.##.#..##
#.#.#....#..###
##.###.#..#.#.#
#.##.###.####..