15 15 0
5 3
14 1
.....####..#.##
#...#........##
#...#....#.#.#.
.#..###.#.#.#.#
...#.#.#.##...#
##..##.##.#.###
.....#...#.#.##
..#..##....##..
#.......##.#...
#..#.#..##.#.#.
#..#.###.##..#.
#........###.##
....###.#.#.#..
...#.##.##...#.
#...#..#..###.#