15 15 0
14 5
3 13
..#..##......##
##.##.....##...
##.##...###..#.
##...#.#...##..
###......##..#.
....#..#.#...#.
..#.#..#.#..#..
..##...#.#...#.
#.#.#.##..##.##
....#.##..##...
#.........#....
##.....##...#..
.#..#..#.#.##.#
#....#...#.....
.##...##.......