15 15 0
6 11
9 11
.#.............
...#..#..#.##.#
.#...####.#..#.
..##..#...####.
..##..#..##....
#...#.##..#....
...#.####.#.#..
..#.#.#.##..#..
..#...###.....#
#.#.#.###.#.#.#
##.......#...##
####.###...#..#
#..#..##..#####
.###....#.#....
.....#.#.#.....