15 15 0
6 7
6 10
.#.#.#.#.###...
#.####..#..##..
.....#..#.#.#.#
#..#.##....#.#.
.#...##....#.#.
.####.#.##.#.#.
.##.##..#..##..
...####.#.#..##
#.#...#....#...
..#..#.##....##
.....###......#
..#.#..#.#...#.
#..#...#......#
..#####.###..##
##.#.#...######