15 15 0
9 5
7 6
##.##..###...#.
.##.#...#....##
#.##.###.######
#.###...#.##..#
..###.##.####.#
##..##.#.##..#.
#..##..#####.##
###....##.###.#
.#.#.##.##.###.
###...####.#.##
##.#..#.#.#.#..
.#...####.#####
####.##..#..#..
....#.#.#.##.#.
.####.##...#..#