15 15 0
12 4
11 3
####.#.##....#.
#....#..#..#.#.
....#...##.##..
##.#..#...#...#
###.#######.###
.###..#########
.###...#.##..#.
#####..#.#.#..#
###.#..#....##.
...##.#.#.##.#.
#..####.#.##.##
..#....##.#..#.
...#...##.#..#.
.##.##...###.##
#.#.###.##..##.