15 15 0
9 7
2 9
.##.#.##....##.
.#...#.#.#.....
###.#.#...#####
#..#..#.#.#.##.
..#....#..##.#.
#.####...#....#
....#...#####..
..#..........#.
..####..#....#.
#######.#.##.##
....#.....####.
.....#.#..#.#..
..#.##..#..####
##.##..####...#
..#..#.####.#.#