15 15 0
13 2
11 2
.###.....#.#.##
##....###....##
##.#.##..##.#.#
#.#.##.#######.
...#.#.####....
.########.#.###
######.####.###
..#.####.##.##.
.###.####.#..#.
###.#.###...#.#
##.#......##..#
...#####.#####.
##.##....####..
##.#####...##..
#.#...###.#..#.