15 15 0
1 3
13 14
..#..#.......#.
##...##.....#..
#.##..#.###..#.
........#..###.
##.......##...#
....#.##...##..
###....####.##.
#.#.##.##.###..
#.###.........#
#.####.##.##..#
...##..........
....#...###....
.#....#........
#....#.#.#.#.#.
.#..#....##...#