15 15 0
6 2
2 8
.###..#.###....
...##......#..#
#....##..#...#.
###...#...#.#..
#.###.#.####.#.
#..####.......#
.#....#.#..#.##
.#.........#..#
..###.#....##..
#.###..##.#.#.#
.#...#.#.......
.#.#.#.#.##..##
.##...#...#.#.#
.#..###..#....#
.#..##..#......