15 15 0
2 4
3 5
#....#...##..##
#####.#.....#.#
##....#..###...
.##.#..##.##.##
.#.#...#..#.#..
...##...#..##.#
....###.#.#..#.
.#.####...#####
#.##..#.###....
.#.##...#.##.#.
...####.#.#...#
.####...#.#..##
.#......#..#...
.#...#..#..##..
....#...#..####