15 15 0
7 7
5 5
#.##.##...####.
#.###.##.##..##
#.....#####.##.
..#..#..##..#.#
#..######.#.#.#
##..#......####
#..#..#.##.....
#..##...####.#.
.#.###.###..##.
.#.....#..#.#.#
##...#..##..#.#
#......###.####
#.....###.#.###
###.....##..##.
.....##.###....