15 15 0
9 5
12 3
#####.###.....#
.##.#..###.##..
####.#....#.#..
###...#.#..#.##
#.####.##.#.###
######....##.#.
.#..##..#.....#
#......###.#.#.
##..##.###.###.
##..#....#.####
...#...####.#.#
##.##..#.##..##
#.#....##.##..#
....#...#...#.#
..##..#.###.##.