15 15 0
0 6
9 7
.##..#...#.##.#
#......##.#..#.
##.#...#.######
..#.#......#...
#.###..#.##....
#.....#...##..#
#...###........
#..#....#...#..
.....#..#..#.##
#............##
.#.####.#.#.###
.#.............
.#.#......#..#.
##..##....#..#.
#..#......#..##