15 15 0
9 3
10 7
#...##....#.#..
#.##.###..##.#.
######..##.##..
#.##.#.#.##..##
#.##...#...####
##.#...#..#####
.##..#......#..
#..##.##.#...#.
##.#.####.#..#.
.#....#..#..#..
###.....#####..
.###.###......#
.##.....####.##
##.#.###....###
.##.....##.#...