15 15 0
9 8
6 5
##...#.#####.##
...#.#.........
......##...##..
...#..##.#####.
#.####.#.#.#.#.
.##.#..#####...
#..#....##.##.#
##.#...#....###
...#........#..
#..#..#.....##.
....##.....#..#
.##.####......#
...###.###.#.#.
##.#.#......###
.#.....####.#.#