15 15 0
12 3
9 2
#..###.#######.
#......#.##.###
#.###....######
.##.###..#.##..
#..##.#..##.###
#...#...####...
#...##..#..#...
....##....##.#.
.###....##.....
.#.....##.#.#.#
##..#.##.##...#
.###...###.#.#.
#...#..#...##.#
.#..##.##..#..#
........#...#.#