15 15 0
0 10
0 6
.####......#.#.
..####....#....
.###...#..#.#.#
###..####..#.##
...##...#.#..##
#.#......##..#.
..#....#.##.#.#
..#.......##...
#.#.###......#.
#..##.#.....#..
..##...##..#..#
#.##.##.#......
##.#....###.#..
.#..##..#....#.
#.#.##..#....##