15 15 0
14 4
7 0
##..####.#.####
..###..#.###...
#.#.##..#..#.#.
.#.#.#...#..###
.#......##..#.#
....#...#.....#
..#..#.##....#.
...............
#.##..#.###.##.
.#.#..##..##...
......#..##.###
.....#.#....#..
#.##....###.#..
...#........###
####..#...##.##