15 15 0
14 1
13 6
..#.###..#.#.#.
.....###.#.####
#..#.#.##.#..#.
.....####.##...
#.#..#....#....
..#...######...
.#..####.##...#
#...#...#.#.#..
..##.#........#
..#.##.###....#
..#.#..##...#..
..#.#.#...##...
.........###.#.
#.####....#..#.
.....#.####.#..