20 20 0
16 16
12 10
#.#...#.........##..
.......###.#....#..#
##...##.......#.#..#
.#.#..###...#.##....
..#.##.##..#....#.##
.#..##..#.#.#...###.
#.....#..###.......#
#.###...#..##..#.#..
#..#..#.##.....#...#
#.#..#..#.#....##..#
..##...##..#.#...#.#
#.#....#..###...#.##
..#.#.##.#.#..#..#..
#..#...##.....#...#.
#..##...#####.#..#..
.#..#..####....#.#..
.#....##.#.###....#.
##.##.....###.###..#
...##.##.........##.
.#.###...##..####...