15 15 0
13 10
0 4
#.#......#.#.##
..####..#.#.#..
.##...#.#...#..
#....#.........
.#....###.#.#.#
##..#...##.#..#
.#...#....#.#..
......###.....#
#..###..#.#....
#.#.#..#.......
##.....##...#.#
....#.......#.#
..#####..#.##..
.#.....##..#..#
...#.#.#.#.#...