15 15 0
5 2
1 7
####.#####..#..
..#.....###....
#..##.#.##.#.#.
..#...#.....###
#.#...#....#.#.
......##...#.#.
##...##..#.##..
..###.#....#.##
..#.#..######..
##...###.####..
.##.###.##....#
#..###....#..##
....#...#.....#
#.##..##......#
##.....##.#.###