15 15 0
7 14
3 10
......#.#.#.#.#
##.......####.#
#..##.......#..
.#...##..#.#.#.
.#..#####.##...
##.#...#.#.##.#
.#...#.........
.#.....###.#...
####.#..#......
####.#.###....#
..#.#....#.####
#..#......#..##
#.##....###.###
.##.##.#.#.##..
#.##..##..#.#.#