15 15 0
4 0
1 5
#.###.###.###.#
#.##...#.#...#.
##.##..#..###.#
...#....##.....
......###..####
#.##..#.##.##.#
###..#....#.###
#.###.#######..
##.#..#########
.##.#.##...#.#.
.##..######.#..
#.#####.##...##
#.##.###..####.
...#.##..#.####
#.###.##..##..#