15 15 0
4 10
3 13
####.#....##...
##.####.###.###
#####...#..#..#
#.#..#...#.....
...#.#.....##.#
.####.##.##.#..
##.##..###...##
.##.##..#...###
##..###.#.#.###
###.##..##..#.#
##.....###.###.
.......##..####
...####.#####..
###..#####...##
..##.##.#.#####