15 15 0
9 3
8 3
.#.##.##.###...
.#...#...#.####
...#.#...#..##.
.#....##.###..#
..#.##########.
..###.#..##.#.#
.#..##.##.##...
##..##.#####.#.
.#..###.#.#..#.
##....#..#...##
#.#.....#####..
##.##.##.####..
#...#.###.#####
###...##.###...
...#...#.#.##..