15 15 0
3 8
7 0
#.#.#.#..###.##
##...##.#..#.##
.##...#.##..#.#
....##...#.....
#.....#..#..##.
#...#...##.###.
###..#..###..#.
..###.#.#.##...
........#..#.#.
..#.#..#..#...#
..#..#.#..###..
#...##.#.#.###.
.#.........#..#
.#.#..#..#...##
.##.##.##.#.#.#