15 15 0
2 4
13 10
##..#..##.##.#.
###.........#..
.......#..####.
...##..#.#.....
#.##.#.....###.
#.#..#.#..##...
#....#...#...##
.##..#..#..##..
..#.........#.#
..##.#....#.##.
#.....#.#.#####
...#..##......#
#.#......##.#..
.#..#..###..#..
##.#.#.#.#...##