15 15 0
10 4
14 10
#..#.#.#....#.#
.....#.#....###
.###.#.##.###..
###..#.##...##.
..#.#.#....#.#.
.#...#...#.##..
..#.##...#.#...
#.##....#..#..#
#.#.#.#.##.###.
..##.##.##.####
#..#.#########.
##.#.#...#...#.
...#.......#...
.###.###.#.#..#
##...#####..#..