15 15 0
12 8
6 3
.#...#...#.##..
#...##..#...##.
..#..#..#......
#..#....##.##.#
.#...#.##......
..###.#..#.#.##
#.....###.#....
.....###...#...
.#.....#.###..#
..##.#..#.##...
##.#..#.#.#...#
###..#........#
#.#..#.#.#.##..
.#..##..#.#.###
.#..#....#.#..#