15 15 0
4 11
13 2
####.#..#.#...#
####....###..#.
.#..#.#.#...##.
......#.###.#..
###..##.....#..
#..#...#..#..##
.#.##.#...#.###
..#.#.#...#...#
###.#.##...#...
.#.......#.###.
#.#....##..#..#
..#...#.#..#.#.
..##.####.##.#.
.....##.##.###.
.....##.#.#..##