15 15 0
4 2
2 5
#######.#.....#
..#..###.#.#.##
......#..#.....
##..#.#.....##.
##..####.#.###.
.#........###..
.#...#.##...#.#
..#.#.##..#...#
........#.#.#..
#.####..##.#.#.
.####.#.##.....
.##.######.#...
#......##..#.##
#..##..###..#..
.#...#..##.##.#