15 15 0
11 14
8 4
.#....##...#...
.##..##.#######
......#######..
......#.##..##.
.....##..##....
.###.#....##.##
#....##.#....##
#.#.#.###.#.#.#
#.#.......#...#
.##..#.#.###.##
.....####.#....
##.###.#..##.#.
#.#.####.#.####
#........#...##
.##.##..#######