15 15 0
6 12
3 2
....##......#..
#.#..####....#.
#...#...#..#..#
.#..#...#..#.#.
##.........##.#
..##..#...#.#..
.#..##.#......#
..##..##.#.####
...#.##...#..##
#....#....##.##
....##...#..##.
##.#...#.####..
#.....##.#..#.#
..#......#.#...
...#.#..#..#.#.