15 15 0
7 7
1 1
....#.....#.#..
#.#...##....###
....#.##.#.#..#
..###.#..#.###.
#..##...##.##..
.#..#####..##..
#.....#....#.#.
.#.#......#..##
.....#..###.##.
.#.#.##.#.#.##.
##.............
##...#...##.#.#
###..#..#.##...
#.#..#..#..##.#
.###.#...##..#.