15 15 0
8 13
9 6
.....###.#.####
.#.....##....##
.##.###.#.##...
#.###......#..#
.....##...#.#..
.#...##...#..#.
#.#.#.#.#.#.#..
##..##.....#...
######..#.#.#.#
#.#..#.##.#..#.
....##...##....
.........#####.
#..#.....#.....
...#.#..#.####.
#....#.#..####.