15 15 0
9 4
4 11
##.#.....#.#.#.
#########..####
##......#....##
.....#.#.######
.#####......###
#####.........#
#.#.##.##..#..#
##.....##.##...
##...#.#.#.....
#.....####.####
...##.#..##.##.
##..##.#.###..#
..#..#.######..
###.###.#.#.#..
#.#.###.#....#.