15 15 0
9 14
6 13
.#.#...##.###..
........#.#...#
#..#..#..##.##.
#.##.##.#..##..
...#...#...##..
#....###.######
##..###.###....
.#..#..##.##..#
.#.###..##.##.#
#..##.##.##....
###..#...##...#
...####..###...
###..##.#.####.
##.####....#..#
....#..###.###.