15 15 0
10 2
9 5
...#.#.##...#.#
....#....###..#
##..#..#....##.
..#.#....#.###.
###.....#..##.#
.....#####.#.##
###.#.##.###.##
##.#.###..#....
..#....###.##..
.#....##.#####.
.#........#..##
.....#.##.#....
#..#.##..#.##.#
##.##..#..#..#.
..#####.#.#.#..