15 15 0
6 10
8 14
.#.....#....#..
.#...#.#.##.##.
##.##.##...#...
##.#.###.######
.####.#..#.....
##.#...#.....#.
.....##..#.....
.#.##.#......##
#.##.#.##.#....
###......#.....
##..######...#.
.....#....#..#.
##.#.....#....#
......###..#..#
..####.####....