15 15 0
0 7
4 3
.....##.##.#.#.
#.##.#...#....#
.#...#..#.#.##.
#....##..##....
#.....#....#..#
#....#...#..###
..##...##.#..#.
.##......#.....
#.###.##..#..#.
.####.#.#..####
#.#.###.##....#
....#..##..##.#
.#..#.#.###..#.
##.#....#.#.#..
#.#.###....#...