15 15 0
7 7
10 4
..#.##..#....#.
..#.##.....##.#
....#..#.##...#
.#...#.#.#####.
##......##.#.#.
.##.###....###.
...####.##.##..
#....##.....#..
####....#...#..
#.........#..#.
...#..#.....#..
###..#......##.
#...##..##.#...
..##.###...#.#.
.#..##.#..#.##.