15 15 0
3 13
7 6
..#.....#.##.##
.###.....###.#.
.#.#....##.#.##
..#..#.#.#.##..
#...#.###.#....
##..#.###...###
....#.###.##.##
##.###....###..
#.#...#..###.#.
.........#..##.
#..#.####...#..
#..###.##.#...#
#####...#...##.
#.###.#.#..##.#
.#.###.#..#....