15 15 0
11 3
10 6
##.##...##.#...
.#.......#...#.
##.#..#..#...##
####..#.#...#..
.#...#.###.#.#.
..#.#..#####.#.
........#...#.#
#######.##..#.#
.#....#.....#..
##..#....##.#.#
....#..#....###
#...#.###.#.#.#
...##......####
#...#...#.##...
.##.#..#..#..##