15 15 0
5 2
5 1
#....###..#....
..#..###.#..###
##..##.#...##.#
..##.###..####.
.##.##..##.##..
......#...##...
..#...##.....##
#....#..###.###
......#..##.#..
#...#...#.....#
..#.###.##.#.#.
########....#..
#....#..#...##.
##....#.....#..
#.##..#.##.....