15 15 0
4 3
13 5
#.##.....#.###.
...#....##..#.#
#......#.#....#
.##..#..#####..
......#.#.#.#..
.#####..##.#.#.
.#..#.........#
##...#.#..##..#
.#.#....#.....#
#...#.##..##.##
....##.#.#...#.
...#..#..#..##.
.#..#.....#....
.........##.#.#
.##....##...##.