15 15 0
6 6
2 9
###..#...#....#
.#.##.#.#######
.###.##.#.#....
..##.#.#.....#.
#...##.......#.
#..###.###.#..#
..#.##.#.####..
...#..#..####..
...#.#...##...#
.##..#.#...##..
#.#.#.#....#.##
#......#.#....#
.....#.#..#.#..
####.####.#...#
.#.#.###..##.#.