15 15 0
13 4
0 3
..#...#.#..#.##
....#.#####.#.#
.#.#.#.#.#.#..#
#...#.#..#.####
....##.#...#.#.
.#.#.#..#..#.##
.#..#......####
.#####..##....#
...........##..
.##.#........##
..####.......##
...#.#.#.#....#
..##...##.##..#
...#..####..#.#
#.#.#..#.#.###.