15 15 0
7 2
10 1
.##..#...#####.
.###.#.#....#.#
#.#.....###...#
.#.#.#..#...##.
.#.#..#.#......
#.##..##......#
...........###.
.#..##..#.##.##
.#..##..#...#..
.##....#....##.
...#.########..
#..#..#..#.##..
.#.##..####.#..
.#..##.....#.#.
.#..##..####..#