15 15 0
6 2
13 10
.##.#####.#..#.
......#.##.####
.....#.#.#..#.#
...##...#.#...#
.#..##.###....#
##..####....#..
#......##...##.
#..###..#.#....
...##..###...#.
##........##.#.
#.#....##.##.#.
.##.....#...#..
#.#...##....#.#
####..#.....##.
.....#.......#.