20 20 0
18 2
14 0
#....#.##.##.#.###.#
###.###.##..###....#
#.#....#.#...##.....
#####...##...#...##.
.#.##..##.#...##....
..#...#..#.#.#..#...
#.#....###...##...##
#.####..##.##....###
.##..#.#.#....##....
..#..#..###..#......
..##.#...#......#.##
##.#.#####..#..#..#.
#.##.#...#.#.#..#...
###.###.#..#....###.
...#......#...#.....
#..#.#.##.##.##..###
##.###.#....##.##.#.
...#...##...#...##.#
.#.##.##..#..#.#..#.
..#..#.#....##..##..