15 15 0
5 7
1 3
#..#...#...####
#...#..#.##...#
#.#.#..#.#.....
..#..###....#.#
##.....###..#..
#....#..##.#...
#.#.#####.#.##.
#.#.#...##.#...
##....####.#...
#..######.###.#
###.###.....#.#
.#.#.##..###..#
#.#.##..#..###.
#...##.#.#.##..
.###..####..#..