15 15 0
3 0
5 1
..###.##..##..#
.#..##.##...###
##....#.....#.#
.........###...
..#..###...####
..#..#..#.#....
#.#..##.#......
#.####........#
...#....#.##.#.
.....#..#...##.
#..###..##....#
.#...##.#.##..#
.#.##.#..##.##.
##..#####.##...
....####..##.##