15 15 0
7 2
5 3
##.##.#..##....
#.#..#.##.##.##
#.##.##.#....#.
..###..#.....#.
..###.####.###.
........##.#..#
####....#.#.#..
.#...#..#......
..##.......#.#.
...###.#...##.#
#..#..####...##
##..##........#
##.##.....#....
.##...##.##...#
.#.....#.#.....