15 15 0
12 9
8 13
...#.#.##..#.#.
#.#.#.#.##.###.
#......#...##..
.#...##.#..####
##.##.#..#....#
##.#....#.##...
.#####..#......
#......##....#.
##..#########.#
.#.#.#####....#
#..##....###..#
#.##.##.####..#
..#...#.#......
.#...#####.....
####..##.##.#..