15 15 0
0 7
0 8
..#...#..#.###.
.#.##.#...#...#
#.##.#.#.#...##
....#...###....
#...###..###.##
....###.#...#.#
..#...#..#.#...
.######....##..
##.#....#######
##.#.#####.#..#
....###....####
.###..#.#...#.#
.##.#..###.####
#####.##.##....
.#..###.....##.