15 15 0
14 6
12 4
.#..###..#.....
#.#.##.#...#.##
..#...#.#...#..
....#......##..
.#..##.####....
.##..#.#..#.#.#
.#..#....#.##.#
..###.#####....
.####.##..##.##
....##..##..###
........##....#
####..#.#..####
..#....####....
.#...#..###.###
....##..###..#.