15 15 0
8 8
7 7
##..#..##....#.
...####...#.##.
##..####...#.#.
.#...#.#....###
.#....##.....#.
##...#.....####
..#.#....#.##.#
..........##.##
##.##....###.#.
....#.........#
#.##.......##..
##.#.#..##....#
#...##.#...#.#.
.#..#..##.#.#.#
.##..##.#......