15 15 0
6 14
4 14
###.#.....##...
.#...#.##.#..#.
..#.......#..##
##...###....#..
..#..#...##....
........#..#.#.
#..###.#..##...
.##...######...
...#.#..#.#..#.
####....#...###
......#.#..##..
##....#.#.##..#
..##..##.#.##.#
#..#.....#.#.##
...##..##.#...#