15 15 0
8 5
11 6
.###..##.###.#.
##....#.##..###
###......##..#.
#......#..###.#
####....##..##.
###...##.#.#.#.
.#...#....#..#.
####..#.#....##
#.#.....#......
##...###....###
#.....#..#.###.
#...##..###.##.
###.##......##.
..##...#.#.##.#
..##...##.#.##.