15 15 0
5 6
4 5
#.#.##...##.##.
#..#.##..#..###
.####.##.#.###.
#..##.##.#.#.#.
#.##......#.##.
#.####.....##.#
..##.#######.##
#.#.#..#.#.#..#
.#.###.#.##.#.#
##.##.#..#.#.##
####.#.......##
##.#..###..#.#.
.#....#.####.##
##..#...#..#.##
.###.....#.#..#