15 15 0
9 4
6 13
#...###....##.#
....##.#..###..
.##...#...##.#.
......#......#.
....#.........#
###.#.#..#.#...
.....#..#..#...
##.#..#..##...#
..#...#..#.....
###..#....#....
#....#..###..#.
#..#.##.#...##.
..##...#.###..#
....#.##.#..###
.#.#........#.#