15 15 0
5 5
12 4
#.####........#
#..#.##.#..#.#.
##...#..#.###..
...##.#..#.###.
..#.###..#.#...
#.#...#........
.#..#.##..#....
#.#..#...#.###.
.###.#..#.#####
.#........#.##.
...##.#.#..#...
#.#.#.#####....
...#..#.#.#.##.
...#.#.#....###
.##..#.#####...