15 15 0
1 12
5 14
####.#.#.#...#.
###.###.####.##
.#..#....#.....
##.#.#.######.#
#.#####.##.##.#
#.###.#######..
##.#.###.##..##
.###.###.####..
#..####....###.
####.#..###..##
#####.#.#######
#.##.#..#.#...#
.#####..#.#.#.#
#.##.#.###.....
..###....######