15 15 0
10 7
5 3
#.....#...#....
#..#....##.....
..#.#..#..####.
#...#.##..##..#
#..#...#.#...#.
.##.#..##...##.
#.#...#.#...#..
..#.....#....##
....#.###.#...#
#....#...##...#
.#.##.....##..#
#..#....##...#.
.#...#.#..###.#
#.......###.##.
##.#.##.##...#.