15 15 0
4 10
2 3
#.##.#.#.##.#.#
.###....#.#...#
......#.....#.#
.#.#.#..#.#.#..
....##.#...####
#.....#...##.##
..###..##.##.##
#.#.##...#..###
...###....#..#.
..#.#..####.##.
#..##...#####..
.###...#...#.#.
#.###.......#.#
.##..##.##..#..
##..#..##..####