15 15 0
13 11
10 14
..##.#....#.#..
..##..#...###..
###.........#.#
#..#.......#.#.
...#.##.##.#.##
#..#..#.#....##
..####.##...##.
#..#..#.#####..
....#.#...#.#.#
..##.#..###....
######...#..#..
###...##.#.#...
.####..#.#.#.#.
....###..##...#
#.....##..##.#.