15 15 0
3 4
2 0
####........#.#
....##.#.##....
..#.#.###.#..##
#.#..#....###..
..###.##...#...
.#...##.#...#.#
##.#.##.#...#..
.####.....#..##
.#...##..##....
....#..##.#..#.
#.#.#....#...##
.....#.#.#...#.
.##......##..#.
#.##.##.#...#..
#......#......#