15 15 0
14 2
14 8
##.#.###....##.
..###.#.....#..
.....####.#....
.#...##....###.
..#..##.#.#.#..
.##..##...#.##.
#.#####.##.#.#.
##..####.###.#.
##...#.#####...
#.........##...
..#.#.###.#..#.
..#.##........#
###..##.##....#
.............##
....##.#.###...