15 15 0
6 4
7 5
######.#.###..#
#..#.####.##..#
.#....#..#...#.
.##..#....##.#.
.#.#.##....#.#.
##.##..####.#..
.#....##..##..#
#...#..##....#.
.###..#.#...#.#
#....###.##.###
..#.###..#.##..
..#..###.....#.
.##.##.##..#.#.
#..##.....##...
...#..#.#...##.