15 15 0
7 9
12 4
..#.##....#...#
.#.#..####.###.
.##.#..###..##.
.#.####.......#
..#..##.#.#....
.###.#.##.....#
.##.#.##.......
...##..#...###.
.##.#...##...##
#..##......#..#
.#.....#.##.#.#
#...#.##..#..#.
#.##..#......#.
###......##..##
#...##.##..#.##