15 15 0
10 12
3 4
.#...##..#.##.#
#..#..#..#...#.
..#.#.##..#....
......#..####..
..##..###...##.
#....#.....##..
..#...#...##..#
#..#....#....##
.........#.#.#.
.##......###.#.
#....#..###....
.#....#.#.#.#.#
....###..#..#..
.###.##....##.#
..#..#...##.#..