15 15 0
1 8
0 11
.#...#.#..#.##.
###....#....#..
##.....##.###..
#..######.##.##
#.#..#..#######
#####.##.###.#.
.##......######
#..##########..
###.#########.#
#.#######.#..##
##..###.####.#.
##......#.##..#
###.##..#####.#
..#######....#.
.##.###.###...#