15 15 0
8 0
7 9
......##..#..#.
...##.#.#......
#...#.......#.#
#...##.#.###...
#..#####.#.#.##
#####..#..##...
.##...#.##..##.
..........##..#
..###.#...##...
.#....#.#.#....
....#.##.#####.
.#.###..##...#.
#.#..#...##.#..
#.#..#....#.#..
##.##.#.#...#..