15 15 0
2 11
3 11
...#.....##.##.
#.....###.###..
...###.##......
##.#.#.#....###
.#...#......#..
..####.#..#.###
..#.#.....#..#.
..##...###.###.
####..###.#....
#..##......#.#.
...#...#..#.##.
......#.#.##..#
.......#...#.##
..####.##..#..#
..#.#...##..###