15 15 0
0 5
1 7
#..##.#.#.##.#.
##..#....#.#.#.
#..##.###.####.
..####...##...#
..###.#.##.###.
##.#########.##
###..##.#..###.
###..##.##.#.##
.####..#...#.##
####...#.##..#.
##...#..#...#..
#.#####....##.#
##..#.###....#.
.#..#..#..##.##
##.######..####