15 15 0
4 10
4 13
#..#..#....####
#...#.###.#..#.
#.####.##.#.##.
....##........#
....##..#.....#
.#.#...#...#..#
.#..##...####..
##..#..###.##.#
#.........##...
...###...###.#.
#.#.##...###.#.
#...#######...#
#.#.#.#..####..
###.#.##...#.##
#..####...#.###