15 15 0
2 13
7 14
.....#.####....
.........###..#
#.##.....###...
#.#.###..#.#..#
.###.####......
#.....#...#.###
....#..#..#.##.
##......#..#...
...######.....#
.#.........####
...#.##.###..#.
.#...##.#####..
#.....##...###.
.#.#.####...#..
#..#......#..##