15 15 0
13 5
14 4
.###.###.####..
.####..########
###.##..#######
#.#...#####.##.
###.#...#.#####
...#####....###
##..###.##..###
..#.####.#.##..
####.##.#######
.##.#####.#...#
#....#.##.##.##
#.#.###.......#
##.#.##.#######
##.....##..####
###..#....#..#.