15 15 0
9 13
11 10
#..#..##.......
.######.#.#..#.
.##.#..###.####
..####.##..##..
..#.#..##..####
#.#......##....
..#..#...##.#..
#..#..#.#.##...
..#...#.#..#..#
.....#.#.......
#....###....##.
####.###....###
....##.#####.##
#.#.##....#.#..
.#...##.#..##..