15 15 0
7 8
6 12
#.#....###.####
.......#####...
##..###.##..#..
....#..###..##.
.#.#.#..#.##...
.........##....
####.#.#..#...#
#.#.##.#..#...#
#..##..##......
...####..##.##.
####..##..#.#..
#..#.###.#....#
#..##..##..#...
#.##.#.##..#..#
#..###.#.####..