15 15 0
0 6
1 12
.##..#.......#.
#...#...####...
##.##..#..#.###
.#..........#.#
##..#...##.#...
#...#.#...###..
##....###.#.#..
###.#.......#..
...#...#..#...#
...#..#...#####
.#....#...#..##
.###..##.#..##.
###.#.#.#.#.##.
.##.#.####.....
###.##.##.#.##.