15 15 0
10 11
10 9
.#.....##.#...#
.#..#..#.###...
....##..####...
#.#.#.#....#.#.
.##..#.#.#.#.#.
..##.####..#.#.
.##..#....##...
...##..###..#.#
.##...#....#.##
##.##.###.#.#..
#.#..####...#..
.#.##..##.#....
.###..#..#.##..
.#...#.#..#....
###.#..#.#####.