15 15 0
9 11
0 5
#.....##.#.##..
#..#...#..#.###
...#.#..#.....#
..###.#..#...##
..#####....#.#.
#.####..#..####
#...#...#.###..
###...####.##.#
#.###.....#..##
.####...#...##.
.###..##.##.##.
####...#.##..##
...##...####...
..#.#.#.#.####.
#...#.##...####