15 15 0
13 13
12 11
###.#..##..#...
###....#......#
##..###.##.#...
...........##.#
.##.#....#..#..
..##.....#..##.
.#..#.######..#
#..###....#....
##.......#.....
#..###...#.##..
#.##...#.#.###.
#.#..##.##.....
#..##.###...#..
...#..#....#..#
#.....#.##.....