15 15 0
12 5
4 10
.#...####....#.
..#..##.###....
#..####.#...##.
#...###...##..#
#..####.#....##
#..#..#..#.#.##
###.#.#.#....##
..#.###....#.#.
....#..#..#..#.
...##....#.#.##
...#....#...##.
..###...##..###
###...##.#.#..#
#.#........#.#.
.###.##..###.#.