15 15 0
5 4
10 0
##.#..##..##.##
#.#.#####..#..#
...##.#..#.####
..#......###.#.
..#..#.#...#.#.
.#...###.##.#..
###...#.##.##.#
.###.#...##.#..
..#..#.#.###.##
#..#...#.###..#
..#.#..#.##..##
.......###..##.
#.#.....#####.#
###.##.#.#.##..
.#.....#.####..