15 15 0
3 10
12 13
.###.#.#.#....#
..##..#..#....#
#.#.##..#.###..
#.....#.#....#.
#..............
.##.#.###.#.##.
......#...#...#
.#..###.##.#...
..##.........#.
#.#.##.......#.
......#.....#.#
.##............
.##.##..##....#
..#......##....
#..#.#..#...#..