15 15 0
7 6
5 1
#.#...##.####..
##...#.###.....
##..#..###.....
.#...##.##....#
....#.#..###.##
#..#..##..###..
..#.##.#.#....#
#.......#.##.##
.######..###.##
.##.#.#..#...#.
.##..#.###..#..
.##...#.#.#.##.
.#.##.....#....
##...#.##.#.##.
.#####.##.#...#