15 15 0
8 6
2 2
.#.#.###.#.#..#
..#..#..##.####
.#..#####..#...
...#.#..#.#....
..##..###.#..##
#...#.#....##..
#...##.#...#.#.
...###..#.##.#.
...##....###.#.
........#....#.
####.#..#.#...#
.##.#........#.
###.###.#......
..#.###.##.##..
.####...###..#.