15 15 0
9 1
11 8
.##....#.##.#.#
..#...##....###
..............#
#..#....#.#.##.
####.#..#....#.
.##.##..#.###.#
.###.#.....##..
.#..##.#.#....#
..#..##.#..##..
#....#.#.##.##.
#.#........#.#.
.###...#.....#.
.......#.#.....
.#.##.#..##.#..
#..##..#..#####