15 15 0
14 11
7 2
#.#.#.##.#####.
##.....#.##.#..
....#####.#...#
#....#.###.#...
.#.#..#....##..
#....####.#.##.
..##...#...####
##..#...#.#...#
.##.####..#.#.#
##..#..####...#
.##...#.##..#.#
..#..##.#.#....
....##.....###.
..#............
#.#......##....