15 15 0
13 7
4 2
.........##.#..
.##....#..#...#
.###..#.###...#
......#.....#..
....#...##.##..
...#.##...####.
#..##...#.#....
.#..........#.#
#...#..###...##
...#...#....#..
#.###......#...
##.#.##..#..#..
.#.........#...
..#.#.#..##....
#.##..##.#.....