15 15 0
1 5
12 4
........#..#.#.
#..............
##....#...##.##
#....###.##.###
.#....##..#...#
#.#..#.####.#..
.#...##..#.#..#
.#......#.##.#.
..#.....#.....#
.....####.##.##
##..#......#.##
#...##.#..#.##.
#..#..#.#.#..##
.#.#.###.#.#.##
#......#..#....