15 15 0
9 1
10 7
...##..#..##.#.
.#####....#....
..#..#.##....#.
#.##..##..##.#.
#........#...#.
..#..#####..##.
...##.##.##.#.#
...#.###.......
#.##.#...######
...##.##.#.#...
....###.###...#
.#...#...#.#..#
##......#.....#
#..###.....##..
#...######..#..