15 15 0
7 12
9 10
..##..#.##..###
###....##.#..##
.#..##.##..###.
.######..###.##
.###.####....#.
#.###..###.....
..#...##.#.###.
#..###.###.#.##
###...####...#.
#.#..#.....#.##
#.##.#.#.#.###.
####..#..##.#.#
##..###..#..##.
#..#...##...#.#
...##.###.####.