15 15 0
12 12
8 11
.#....##.#....#
...#....#.#..#.
.##.###..##.##.
.#..#.###..#.##
#..#..#.###.##.
###.#######.##.
..##..#....#.##
#.##.###....#.#
.##..###.#..##.
.##..##.##.....
#.#..#.###...#.
.#######.###.##
..###.#.#....##
#...##.##..##.#
..#...#..#.#...