15 15 0
1 6
5 1
#.##........#.#
##.##...#....#.
#.#####.##.#...
###.#..##...##.
.#.....#..#..#.
....#.###....##
#..##..###.#...
..####.....#.#.
#.#...#.###....
..#..##.###.#..
#..###...####..
..#.#.#.#.##.#.
..##.#####...#.
#.####.#......#
#.#.#.#......##