15 15 0
3 11
3 10
...##.#.##...#.
.#..##.....###.
#....#.#...###.
.#.#..##.#..###
..##.#.....#...
..#..##.#.#.##.
#..###..#.#.#..
##..##.##.#####
...#.##.#..##..
..#####.##..###
.......##..#.##
...####.....###
.#.##..##...##.
.##..#.##.#....
####....##.###.