15 15 0
0 0
14 6
...#....#..#..#
#.......#######
....#.#...#.#.#
##..#.#.......#
...#.#..###..##
...#...####....
##.#..#..##....
##..#..#.###.##
....#..#..##.#.
##..#...#......
.#.#.##.####...
##..##...##.#.#
..#..##.....###
..#.###..##....
.........###.#.