15 15 0
0 10
4 8
#.#....#.#.#...
..#.#.##.#.####
..#.###.#...#.#
...#.#.#.....#.
##.....#.###.#.
..........##..#
#.#.##....#.###
##.....#.#####.
#.###..##.#..##
...#..##..#...#
##.####....#.##
##.......##....
.##..##....#...
..##......#..##
###.#.##...##..