15 15 0
8 8
11 6
#...###..#..###
##.#..##...#.#.
.#.#.....######
#.#.##.#.###.##
.#..#.##..#..##
##..####.####..
..#...#.##..#.#
###..####.##..#
###.###....###.
#..####.#.#####
#.#.#...####.##
#.###.....#...#
#########.#..##
###..#...#.###.
##.#.#.####.#..