15 15 0
6 8
3 8
#.##..###......
.#..###.###.#..
..#..#..#.#.#..
#...##....#.#..
.#.###........#
.#.....#....###
##.#..#...#..#.
.....#..###...#
.#..#..#....###
.##.....##..#..
.#.#...##...#..
..####.##.#...#
...#......#..#.
.#...##..#.#...
.###.##..#.###.