15 15 0
5 10
10 12
#.##..#...#####
.##.#..#...##..
#...#..#.......
..#.##.........
.....#...#.#...
.##.##.#...##..
##..##.###...##
.#......#.####.
#..###.#..##...
....#..#..###..
.##..#....##.#.
##.#.##.......#
#...#.#.#..###.
#.#.#####......
##..#..###..###