15 15 0
6 10
5 13
#...#..#####...
.#.#.#####..###
.#.#.###..##..#
##.####.......#
.#.##..#####.##
....####.##....
....#.#..#.....
#..#...########
####..#.###...#
###..##..###...
.##..##....####
.##...#....#..#
.##.#.#..##.###
#..######.#.#.#
##.#.##.#.#.##.