15 15 0
6 8
13 0
.##.####...##.#
..#.#.#..#....#
..####..##...#.
######.#...###.
.###..##..##.##
..#..#...#.....
#.....##.#...##
...#..#...#..##
#.#.#....#....#
..#..##...#....
..##.#...######
.#...#.##.....#
....###...####.
......##.#.#.##
.#.###...#..#.#