15 15 0
14 10
9 11
##..#.#.##.....
...#.#####.....
....##....#....
.......##..#..#
.#.#..###...###
#.#.#####......
...####...##.#.
...#..#..####.#
#..#.##.....###
#....#..#...##.
.#..##..#.....#
#.#.#..##....#.
###.#.####.#.##
....#..#.#..###
#.###..#.#.#..#