15 15 0
8 2
4 9
####.###.#..#.#
..#.###....##..
####...#######.
##...#...#.##..
#.###.##...####
...#......##.#.
.##..########..
#.##..###.##..#
.#...##.#..#...
#..#.#.#.###..#
.#.#.#.###..##.
###..#..#.#...#
####.#.##..##..
##..#.##.#.#.#.
#..#....#.##.#.