15 15 0
4 3
8 0
#.##..####.#..#
...#.#.##.#....
#..#####...#.##
..#.##.#......#
....##...#.####
...#.##..#..###
....######..#..
...##.#.....#..
..#.....######.
.##.#.#..##.#..
.######.##..#..
.###.##.#....#.
##..#.#####.#.#
#..###..#....#.
#.##...#..###..