15 15 0
3 11
4 9
.#..###..######
.####...###.#..
#..#.#.##.##..#
.#.#.##..#..#..
#.##.###..#.##.
.#...#.##....##
.#...##....##..
.#####.###..#..
.##..##.##.#...
.##..#...#..##.
#####..#..#..#.
..##.#.#....#..
.###.########..
#.#.##.#.###.##
##.#....###.#..