15 15 0
11 12
12 11
.#.....###..#..
#....##.#.##..#
####..###...#..
.#.#.....#...##
#..#.#...#..#.#
#####.##..##.##
######.....##.#
#.#.#....#....#
#.###..##.#..#.
#.##.###.#...#.
#.##.##.#.#....
.##..##.###..##
...##...#.#..##
..##.####.#.#.#
##.###.#.#...##