15 15 0
5 5
2 9
.#.##.....##..#
.#.#..#.....###
..##.###..###.#
..#......#....#
###.....#######
.##...##...##.#
####..##..###..
######..###.#.#
#..#.###..###..
#.#....#.###.##
..#.#.#.#.....#
#..#.####.###.#
...##.#.....#.#
...#....#..#..#
##...###......#