15 15 0
4 5
1 11
..##.#..#.###.#
..#.#..###..#..
##...#...#....#
...#..#...##...
#.#.#....#....#
...#.###.....#.
.#####........#
..##.#..##.#.##
.##...#..##....
.######..##...#
#..#.......###.
...###.###.###.
...#.##..#.###.
.###.##.#...###
#..###..#.####.