15 15 0
5 0
6 8
#..##.....#....
###.#...#...#..
#.#...##...#.#.
.#........#...#
##.#.........#.
...##..#.......
.#..#.....##...
#.#.#.###.##...
.###...#.##...#
#.#.##.#..#...#
##...#.#.#.....
###.#.#....##..
...####....##.#
..#....#.#.....
#...#..#.##....