15 15 0
8 9
11 8
....#.###..#..#
.#.....####....
##..###.#.###.#
..#.##.#.#...##
####.......#...
..#.#.#.#...#.#
.#.......#####.
.#..#...#....##
...........#...
.....#...###...
#####..##.#####
##........#....
#.#..#.........
..#...#....#.#.
##.......###.##