15 15 0
5 10
8 13
#...###.....#..
..##.#.##..###.
####...####...#
.#.####....##..
.####..#....#..
..###..#...##.#
.##.#.#.#.##...
.##........#..#
.#..##.....#...
......#...##.#.
#.##.........#.
#....#.....#...
..#.#.##.......
##.....##.#....
###.###..#..##.