15 15 0
10 9
6 12
.#######.#...##
.##.##..###..##
#..#.#.#####..#
.##...##.#....#
...##.##.....#.
.###...........
#.##.#.#.#.#...
..#......##.#..
.#..#..###..#.#
##..#.###..#...
.##..##......#.
......###.####.
##...#.###..#..
...#.#.#.##.##.
...#.####.#...#