15 15 0
0 8
1 8
..#.####.#....#
#..##.#..#.#.#.
...#..#...####.
#.#...#.##...#.
####.######.#..
.#..##..#..#.#.
#....#..#.##.#.
.#.##..#..####.
#.#.##.......##
.....###..##..#
#..##.#..###.#.
.#.......#...##
.##....##......
.###...##.####.
.#..#.......#..