15 15 0
5 8
7 8
#######.....##.
.....#.#.####.#
#..#.#.#####.##
###.#.##.#...#.
#...##########.
.####.......###
##.##.##.#...##
#.###..#..#.#.#
#..#.#..##.##.#
.#.###.#.####..
.####..###...#.
.###.#..#..##..
#.#...#..###.##
...##...#....#.
..#.#...##.####