15 15 0
13 5
13 8
####...#...####
.#..##....#####
##..##.###....#
######.##....##
.#..##.###..#.#
#..##..#..##..#
####..##.####.#
######.#.##..##
##.#...##.###.#
..#..##..#...#.
.##.#..##.#####
#..##..##......
##.......##...#
...##.#..###.#.
#..#.#.#...#..#