15 15 0
8 1
7 7
....#.....####.
....#.##..#....
..#..##..#..##.
..........##.##
#.....#....#...
..##....##..#.#
..####...##...#
...#.#....#...#
#....####..###.
#.#.#.##.#.#.##
..##.#.###..#.#
#.##.#......#..
#...#####.##..#
.....#..###.##.
####.#...#.###.