15 15 0
8 7
11 12
#####.#...##.##
##....#...#...#
....#....#...#.
.#.....#.#.....
#.#..###...##.#
#...#...###.##.
......#...#.#.#
####....#...#.#
.#..#.#.#..#.#.
.#.####.##.....
.####..##..#..#
#..#.###.....##
#...#..#.....##
.#..#.#.###....
###.#..#..##..#