15 15 0
12 3
14 7
#...###..##..#.
.#.#.#...##....
.#.###...#...#.
##.##...##...#.
###.##.#####..#
#######....##..
...##.#.#.#.##.
##.##.#####.#.#
.#####...#.#.##
#..#..#..####..
.##.##.####....
..#......#.#.##
#.#...##.#.####
#..#.##..###..#
...#....##.##.#