15 15 0
13 7
8 9
.#.#.#.#.#...#.
###..##..#...##
#.##.##.#....#.
..###.#.#....##
#.#....#..###.#
####.########.#
##.##.#.####..#
#....#...##.#..
.#####....#....
#..##..#.###..#
##....#.####.#.
#.#...###.###.#
###........#.##
..####..#.#...#
.#.#.##..#.#...