10 10 0
5 3
9 7
.#.##..#..
..#...#.#.
.....#.#.#
..#..#####
..####...#
#...#...#.
.##..##..#
.##..##...
##.......#
.#..#.....
