15 15 0
14 9
9 9
####..#..#.#..#
###.####.#####.
..##.##.#.###.#
.##...###..#..#
##.##.####...#.
.####.#....##..
##.##.####.####
#.##...##..##.#
####..###.####.
#..##.#.#.##.##
.##..##....#.#.
.#.##..#....###
###.#.#.#....#.
##.####..#..##.
##.##..##..##..