15 15 0
4 12
10 8
#..#.####....#.
##.#.#.#.#..#.#
######.###.##.#
.##....#.#....#
..###.#.#....#.
###.#..#.....#.
#.#..##.##.###.
.#....##.......
...#.###..#.###
..##...#..##.##
####..##.....##
..##.#.#..#####
.#.####.#......
.####..#.#...#.
...##....#.##..