15 15 0
12 10
11 4
..##..##....##.
#...##.##...###
##.#..#..######
...##...##..#.#
##.#.....#.##..
...###...#..#.#
#.###.#......#.
.####...##..##.
.##............
.####.#..##.##.
.#.........###.
...#....#...#.#
....###..#.##.#
##..##..######.
.###..#.##.##.#