15 15 0
12 11
9 10
.#...#..###...#
...#..####.#.##
##.#.#.........
##.#.#..#.#..##
#..#...#.#..#..
.#..##...##.#.#
..#...##.......
..#..#.......#.
.#.#..#..#.#..#
#..##.#....#...
#...#....#..###
.....##.#..#..#
.#..##.##...###
...#.#.####.#.#
.##..#.#.....#.