15 15 0
11 12
6 9
#.#..##.##...#.
..##.#..###....
#..#.....##...#
.##.#..#..#.#.#
.##.##.#.####..
.#..#.#.###...#
#...........#.#
..##.#.#....#..
.#.#.##.###.##.
##.#.##.#......
#......#.##...#
....####.##....
..#.##..#....#.
.###.#####....#
...#...##..##..