15 15 0
11 1
11 7
#.#..####..##.#
#.....##....##.
#..#.#.#....###
##..#..#..#.#..
#...#.#...##.#.
..#....###.#..#
##..#..###.#.##
#..#.#.###.#.##
....##..#.#..#.
...#..###.#####
..#...##.#.##.#
...###...#..#..
#......####.##.
#.###....##..#.
#.####.###..###