15 15 0
14 12
6 9
.#...#..#....##
#.#...#..###...
.#.##.#.####.##
##.#.#.#..#..##
..#...#..##.#..
....#..#.#.###.
..##..###..#...
..#..##.##...##
#....#.#.#.#...
..#.......#....
.##.##.###.#...
.#.#..#.######.
..#....##..##..
.....#####..##.
..##.##.###....