15 15 0
10 3
2 11
.#.#...#..#...#
.#..###....#.##
#..#.....#...#.
.#..#.#...#..#.
.#..#.###....##
##.#..###..#..#
.#....#.#..#...
#..#...#.....#.
..##.##......##
.....#...##...#
###..#.#....##.
.##..#..#.#.##.
.##.....##....#
..#..#..#.#....
.#..#.#.####...