15 15 0
7 12
7 10
##.#..#.#..##.#
..#.##......#..
..########.#...
.####..####.###
.#..#.#...#....
##.......#...##
#.....#..#.#...
....#.#......#.
.###.##.#...#.#
...##.#.....#..
#.##...#####...
###.##..##.###.
##.#..#..#...#.
..#..###.......
.#.##.#..#.....