15 15 0
4 10
11 7
.##..#####..#.#
#....##...#...#
...###......##.
#.....##..#....
.....##..#.....
#.##.##..##.#.#
#....#.......#.
#.......#...#.#
#.......####.#.
#....##....####
..#####....#..#
...##.#.#.###..
...##..#..##..#
.#....#.#..#.##
..#...#...#..##