15 15 0
6 13
6 12
##..#.#####.#.#
...#.##...#.##.
.#.###...##....
#.#.##....##.#.
#.#.##.#..##.##
#.##.#..##..#.#
..##.#####.#..#
#...#.###.###.#
.#..######.####
###..#.#####.##
###.#######.###
##.###...##..##
..##..##.###.##
#######...####.
.####.#..##.#..