15 15 0
7 14
13 10
..##....#####.#
.#.##...##.....
.###..#.....#.#
###....##..###.
##......#...#..
.#..#.#..#..#..
...##...#.#....
..####..#..#.#.
..#...##.....#.
##..#.......##.
..####....#....
.......#...##..
.##.##...#..###
..#.#.#....##.#
#.#....##....##