15 15 0
5 2
2 1
.#........#....
....#..#.#.##..
..##.###.##..##
..####...#....#
.#.#.#..#.#.#.#
##.#.#....#.###
.#..##.###.....
....#...#..##..
......##..#####
........#.#.#..
..#.##...#..###
..####.##..###.
..#.##...##.##.
#.....#####....
.##..#....#...#