15 15 0
10 6
4 14
.#..###.#.#...#
#......#.#.##.#
..#..##.#..#...
####.#.#.##.###
..#...#.##.....
##..#.....#....
.#.#..#.....#..
.##..##.###.###
#.######.......
#.......#...#..
.#...#..####...
.##....#.#.....
...#.#.....##..
#.#.#....##.##.
#.#..#...#.#.##