15 15 0
1 11
10 12
#.##.....#.##..
.#...##..#.....
..#.#.....#.#..
.###.#..#.##..#
..#...#.#.#....
#....#...##.#..
.#..#.....#.#..
..#....##..##.#
#.#....##.....#
###.#...#.....#
.#....#.##.#.##
.#.#...#.#..#..
#....##.#.#...#
.##.##.#..#...#
....##....#.#..