15 15 0
9 14
1 1
.##.#####.#...#
..#.....#.#.#..
#......##..##.#
#..#..#.#.#.##.
....#.....#...#
##......#...#..
..###.....##...
.#.....#......#
#.#..#..#.###.#
##.#...#.....#.
...............
#..#.###..##.#.
...#......#.#.#
###..###...###.
.###.#..##..#.#