15 15 0
4 9
1 7
....#.###...#..
.#..#.#...#....
.#...#....#.###
.#.###.#.####.#
.#.#..##..#.##.
.##.......#..#.
..##...##.#....
##...#....#.#..
.###...####....
#.##.......##..
##.....#..#...#
...#####..##.#.
##.#.##..#..##.
...#..##....#..
.#.#..#.##....#