15 15 0
4 13
6 6
...#..#..###.#.
..#.#..........
###.##....#.#..
.###.#.###....#
.##..##...#.#.#
#.#...#.#...##.
...##.....#....
#.#.....###....
.#.#.#..###....
#####..#..##..#
#.###..#.....#.
##....#..##.#..
.#.##..#...#..#
##.#.......#..#
.#....#...#....