15 15 0
10 2
3 7
##.###.#.###.##
#.#.#.##..#.##.
###.......#.#..
.##..#..#.##.##
##..#.#.#..##..
##..##...#.##..
.#.#...##....##
##.##.####..###
.#...#.#...####
#..#####.#.#.##
##..#.####.###.
####..###.####.
##...#########.
#..###.##.###.#
#.#..#..######.