15 15 0
9 1
3 0
....###......##
#..#.#...##.###
.#.#.#####..###
.####.#.#.#.###
..#####.###.###
.##.###.#####.#
....####.#.##.#
....#...#.####.
.#.#...#.....##
..#.#.#.##.#..#
#..##.##.#...##
##.#.#.#.#..##.
#...######...##
.#.###.#######.
#.###..####.##.