15 15 0
4 11
5 12
.###...#.###.#.
###...####.#.#.
...#..#####.#..
.#...###.##.#..
#..##..#.##...#
#.#.#.#.#.##...
.#..##.###.##..
#.###.#.#.#.##.
..##.##..###..#
.####.####.##.#
.#.#....#.#.##.
####.##.##....#
...##.##....#..
.#...####..#.##
.###.#..#..#.##