15 15 0
5 5
5 9
.#.#.##..##.#..
####.....##..##
#...#..###.#.##
##.##...#.....#
..#.#..##.#..#.
###.....#.#.#..
..##......##...
#..######......
.....#..####..#
..#####.##.....
....#.###..##..
##.#.###..#....
...#..###..##..
#.######.##.#.#
###.###.#.##..#