15 15 0
4 2
5 3
####..##..#.###
##.#.####...#..
.#.######.#...#
.#.###..#.###..
....##..###...#
#.#.##..####.#.
#..###..#.#.#..
.#######..##...
###.##.########
.#..###..##.##.
..#####.#..##..
##...##...#..#.
.....#...#.####
.#.#.##..#..##.
#.##..##.#.#...