15 15 0
8 7
12 9
##.####....###.
#####.#.#.###..
###..###..#.#..
#...#..##.##...
##.###.##.#.###
.#....###.###..
##.##...####...
##.##.##....#..
##.####..#.####
##.##.......###
...#..###.#.#..
...###.#..#.#.#
####.###...##..
##......#..####
#.#....#...###.