15 15 0
9 6
10 8
###.##.#....#.#
.#####.#..###.#
..##.#...####.#
.#..#.#..##...#
..###########..
###..#######.##
#..###########.
##..####.....##
###.####.#.#.##
..#.##...######
##.##....###..#
..#.###..##...#
###.#.##.##.#.#
#.##.###.#.#..#
#..#####.######