15 15 0
14 7
12 8
####......##.#.
###..#.#......#
##..#.###.##...
...#...#.#..##.
.##.#.#..#.....
..#########.#..
#.#.#....#.###.
#.......#.#..##
.#....#.....###
###.###...####.
..##...#.......
..#..#.###...#.
##..........##.
.###..###.#..#.
.........#....#