15 15 0
12 13
9 12
#.......####.#.
...#...####.#.#
..##...........
...##..#...#.#.
...###..#...##.
.###....#.#.##.
..##..#..#...#.
##.#.###......#
###.#.##......#
..#.....#.#....
..####.#....#.#
##..#.###.#.#.#
##.#.#....###..
#.#.#...#...#..
...#.####.#.#.#