15 15 0
2 11
1 10
##.#......#.#..
##.##........#.
.#.##....##...#
...###.#.#.##..
#......##..####
#.###.#....##.#
###.#.#.....#..
.#...##...###.#
#.#..#.##.#..##
.#....#...##.##
.....###.####.#
##.#.#######..#
..###.#.#.##.##
.#...##.####..#
.###..#.#.##...