15 15 0
6 11
13 2
##..#.#...##.##
...###..#.##..#
.##.#.#.##...##
#...#...##.#...
######.#....###
##.#..#.##...#.
#...#..#.##...#
..##..#...#.#..
#......#.##.##.
.....##.......#
#.####......#.#
#.......###.###
#.#.##.#...#.#.
#....##.####.##
##..#..##.#....