15 15 0
14 5
1 4
#..........#...
.....##..#.#...
..#....#..##.#.
.....##...#....
##.....#.#...#.
.####...#.#...#
#..#....##....#
##.#...#...#...
#......######..
.##...#.....##.
...##....####..
..#...#.#...#..
.###...##.#.##.
.#.#..#..#..##.
#.....##..#..#.