15 15 0
1 10
5 6
.#....###..##..
#...##......###
.##...#.####...
##..##.....##.#
#...#.#...#..#.
#.##......##..#
.......##.#.#..
###..##..##.##.
.####...######.
..#.#......#..#
#....#...#.....
#..#.#..#.#.###
#....####......
...#..#.#......
.....#.........