15 15 0
8 4
0 3
#........##.#.#
##...#..####...
#.#..#.###.####
#...#..#.###...
##.##..##.#....
#.##...###...#.
##.#.##...#..#.
#.#..###.###...
#....#.#..#..##
#...###.#.....#
.####....##.###
#..#.###...#...
#.###.....#.#..
###.##...#.#.#.
.#.#.###.....#.