15 15 0
5 5
11 12
....#..##..#..#
..#.#.##...###.
.##...#...#...#
......#.#...##.
.###..#.#.#.#..
####...##.#...#
#..#.#.#.#.###.
.##.....#####..
.#.#....#.##...
#.#.....#....#.
#...#..#####...
.##.#....#.....
.###.###.###..#
#.#.##.#......#
..#...#...#.#.#