15 15 0
1 11
1 0
....###..#....#
...#.#.####.#..
........#......
.#.......#.###.
.#.#####..#..#.
...##...#......
##.##.########.
..#..####.#....
#..#.#....#..##
#####...#..###.
...###..##.#.#.
##.#......#..#.
#.#.#.#.##.#..#
.#..........###
..#####.#..#.#.