15 15 0
10 10
3 14
..#.....#......
#...###....#..#
...#.#.###...#.
.#.#...######..
.....#....####.
#.#..#..##.....
#.#...##.#..#..
#...###.##.##..
##....#.#.#.##.
#.#..#..#......
#.#.#..###...##
####..##...#...
#..##.#..#..#..
...#...###....#
..#.###....##.#