15 15 0
5 9
10 2
........#.##.##
.###...##.#####
#.##.....##..##
#....#####.#...
#.........#.##.
.#...##....##..
.##...##.#...##
..###..#...#.#.
##.#..#.#....##
#.....#...#.#..
...##.#..##....
#.###..#...#...
.#.#..####....#
##.....#...#...
....#.....##...