15 15 0
13 2
12 0
####.##.#.#.##.
...####..##.###
####.###.#..##.
##....##..##..#
###.......#..##
##...##.#..##..
....#.#......#.
##.#...##....#.
##...#.##..#..#
.#.#..#...####.
##.#.##...#.##.
##.#...###..#..
.##..##......##
...####.#.#.#..
#....#....#.#..