15 15 0
10 4
11 3
.##..#..#.....#
.####.#..##....
####.####....#.
#....######..#.
####.#...#.#..#
##.###...##..##
..##...####..##
...#....#.##...
#...#...##..##.
..#.####.#.....
#.#...#.###.##.
..#.###...##...
.#..#####..##..
.....##...#..#.
#.##.#.#..#.##.