15 15 0
1 5
8 11
.#####....##..#
##.##...#..##..
..###..##..#...
#..##.#..#.##..
##.#.#.#....#..
##.#...#......#
..#.###.###.###
#.##...##.....#
#.##.#.##.#..##
.#.##..#...##.#
.###.....#.####
###.#..#...###.
.#####..#..#.#.
##.#..#..##...#
.#.#...#..###.#