15 15 0
9 5
5 8
#...#..####.##.
#.###....#..#..
##.##..........
##....##....#..
#.##.#.#.##....
.###...#.##.###
...#...#.##...#
###..##.....#..
..#..#..#.#.##.
.......#.##..#.
....##....#..#.
..##..####.....
#....##..#...##
#...#....#.##..
.#..#....###...