15 15 0
3 8
2 3
##.....####...#
.##..#.#.###...
.##.....####.##
#.#.###.......#
#.......#.#....
#...###.##.#..#
...#....#.#....
......###.#.##.
.....#........#
.#####....#....
..#..#..#.#..#.
###.####.#..###
...#.......#...
.#....#.#....#.
###.##.#...#.##