15 15 0
4 8
7 0
...#.....#...#.
......######..#
##.#...#..#...#
...#.#.##.##..#
..###.#....####
...#..#.#.###..
.......#..##...
.#..###........
.....#.#....#.#
#.#..##..##..#.
....##.##..#...
...####...#...#
#...#....#.....
..#...#.....###
..#...#....#...