15 15 0
2 0
13 10
#..#....#.##.#.
......#.#.#....
.#..#..##..##..
.#.#..#...##..#
#.###..#.....#.
##.....##....##
##.......#.##.#
.#..#.#....#...
.#.#.##..#...##
.##.....#.#..#.
....##....#.##.
....#..#.#.##..
..#..........#.
...#...#.#..##.
##..#..#..##...