15 15 0
12 6
14 5
###.#..##....##
..###..######.#
#.###.#..#.##.#
#.#...#..####.#
....#..##.#.#..
.#.#...........
..#....#.#....#
#..#####.###.##
#.....#..##....
###.###.###.#.#
..#..####.###.#
#.#.#.#...#.#.#
#....#.#.#..#.#
..#....#..##...
##....######...