15 15 0
12 7
9 3
.##.#....##.###
.#.....##.####.
.#.#.....###.##
###...##.#..##.
#..###.#.#...##
####..#..#..#..
####...###.####
###..##.#..#...
#.....#..#.##..
#.#.##..###.#.#
.##..####.#....
..#......#.#.#.
#.#.###.#...###
.....###.##.###
.##.#####....##