15 15 0
3 7
14 10
#.#.##.........
.#..#.#..##.##.
#.#...##.####..
#..#.....#.#.#.
#..#..###..#...
.#.#.#.##.#####
.###......#..##
#..###..#...#..
...###.........
.#..####....###
.#....#.#...#.#
..###..#.#...##
..##......#.#.#
..###.##.##.###
##.#.#........#