15 15 0
1 3
4 5
#.#...###...###
#...#####..#.#.
...#.#..##..#.#
.#....#....#..#
.#..#.#..###.#.
..#........#.##
.##.......#....
#.#..#.#...#.##
#...###.##...##
#...###..#.##.#
..#...#.......#
#..#.#..#.#....
.##.##..#..#...
#...###.......#
.##.##.#.....#.