15 15 0
8 14
9 6
.##...#.##..###
.###.#..##.##..
###.##..#......
.....#..##.....
#####.#...###.#
...##..#.#..#.#
.#.#.##....###.
###.###..#...##
..#..#####.....
...#....#.....#
...#.#.....###.
#.....#..#.#..#
..#####.#.#..#.
..###.##.#.#...
...#.#######...