15 15 0
11 3
14 5
.#.#.##.#.##.#.
#..#.#...#....#
#.#.##.##.###.#
#...##.#.#..##.
..#..#..##..#..
###..###.....#.
...####..#.....
#.#....#...#..#
###..##........
...#...##...#..
..#....#..#....
.#..#..#..####.
#..##.##....##.
...#.#..######.
.........#.###.