15 15 0
0 3
1 3
#.#.#.###.###..
##..##########.
.##...####.#.##
..###.##.##..#.
...####.##.####
#..#....#.#..#.
.#....##.######
##...#..##.##..
.###.#.....##..
.....#..#.###.#
####...##...#.#
.#...##..##..#.
.###..####..###
##.######.##.##
####.##..#..#..