15 15 0
11 11
5 13
..#...#.#.#....
##...#....#.##.
....##..##.#.#.
.#...#.#.##.##.
#.#....#.#...#.
.###.#..#.#....
..#...##.#..###
.##.#.#....###.
#.##...#.......
.##.#...#..####
#...#...#.###.#
#...#.###...#..
#..#.#..#..##.#
.###..#......##
..#.#..#.....##