15 15 0
13 0
4 1
#...##..#....#.
##.#...#....#.#
#.#.......##.#.
#.....#..##.#.#
......#...####.
.##.#.######.#.
.#..###....#.#.
#...#..#.###...
#.#.####....#.#
....#..#.#.#..#
.#.##....#.#...
#....#..###...#
...#..#.#...###
..........#..##
..#....##..###.