15 15 0
13 4
11 5
.#.##.##.###.##
##...##.##..#..
.##....##..##..
.##.#.###..#...
.##.####.##....
##.##.....#.#..
.......####...#
....##.##.##.#.
..##..#.#.#....
#..##....####..
.##...##....#.#
.###..###.##...
.###.##.##.####
..#....#.#...##
###.###.#.###..