15 15 0
0 0
5 3
..##........##.
...#...##.#.###
.###..###..#..#
........#....#.
#.#..#.####...#
.##.#..#.#..##.
##.....##....#.
.#...#.#..#.#..
##.#....##..#.#
#.#.##.#.###.#.
##.#..###..#.##
.#..#.###..#.#.
##....#.##..##.
.#.##..##..#.##
.##....###...##