15 15 0
2 6
1 1
#.#######.#..##
..#.#.##..#..##
..###..##...###
#..##.##.##.#.#
.#.....#.#.#.#.
#....###..#....
.#####.##.##.#.
###..#.##.###.#
.....#########.
....#..#....##.
..#####..##..##
##.##.#....##.#
#.#.###.#.#.#..
#....#######...
##..#..#.####.#