15 15 0
8 12
7 13
.#...##.##.##.#
...##....#..#.#
#....#.#.#.....
##..#.##..###..
#...#...#.#####
.#.##..........
.....#..#.##...
..#..#..#......
..####....##...
.#.#......###..
...#####.#....#
#.#..#...#.#...
#...#.....#....
.#..##.########
..####.....##.#