15 15 0
4 14
11 11
.#..#.#####.###
.....####..####
.........#.#.#.
#.##.#.##.....#
#.##..###..#.#.
....#..##.##...
##.#....#..##.#
.#..#....#...#.
.#.#......#.#..
###.#.##..#...#
.#....###.#....
..##.#......#..
#...##...##..##
..#####..###...
.#.##.#.#......