15 15 0
8 10
13 10
#..#...#....##.
#.##......#..#.
#..#.....#.#.#.
###.#....###..#
###.....#....#.
##.#.#..##.##..
.#..##.#..#..##
..........#....
..###......##..
....#.##.#...##
..#....#..#..#.
#.#####.#...###
..........##...
.###.#.###.....
##.##........##