15 15 0
11 10
8 12
#.##.#...##.#.#
.#.##..#...#.#.
#..#.#........#
##.#........##.
...#.###.#....#
#####.##..##...
.#..####..##.#.
.##.##..##.#.#.
..###.#..##..#.
#..#..#.#....##
###########..#.
.###..#..#...#.
.##..##.##.#.##
.#..#..#####...
...#....#.##...