15 15 0
1 14
10 14
##.#####.#.#...
####.#....##.#.
.##..##.....#..
.#...#...##...#
.#........####.
..###.........#
...#.##..#..###
..#....#.....#.
#..#.##...##..#
..##...#....##.
.#....##.......
......#..##..#.
#....#.......#.
....##.##..###.
...#..##.####..