15 15 0
11 4
8 0
...#...#.######
#...####.####.#
.###.#..#......
.#.#.#...###.#.
#.....####.#.#.
###.#..###.#...
##...#..###.###
#.#.#.....#...#
.....#..#..###.
.#....#####..##
..#...#..#..#..
#..#..#.##...##
#.###..#.#.####
##.##.##.#.#.#.
.####......##.#