15 15 0
1 9
12 1
.##...########.
#.#....##...##.
####.#.###.#.#.
#....###...#..#
####.##..######
###.##....####.
###.###.#....##
.###.##.....##.
.....#..#..####
###....#.##.##.
#....#.##..#.##
.#...##..#.####
..##.#..#..#...
#....##########
...#####.##.#.#