15 15 0
14 5
10 5
####..#.....#..
##..##.#.......
.#.##.##.#.##..
..#.##.#..##...
##.#####.#.....
..#..##.#......
#.#......#.#.#.
##.###...#....#
#...#.###.#.###
...####...#...#
####...####.##.
#.###...####..#
..#...##..#.#.#
..#..#.###.#.##
#..#..#.#...#..