15 15 0
12 3
5 5
..#.....##..###
.#.#..###.####.
###...#.##..#.#
#...##..#####.#
..#.###..#.#.#.
##.##..###..#..
#.....#.#..#.##
#...###.#.#..#.
......#.#..##.#
###..##...##.#.
.##.#...##.##..
.#..#.#.##....#
.##..#.#..####.
#..###..#.#...#
##..##....#..##