15 15 0
2 11
7 7
.#.#.###.##.###
###......#...##
..#.##.##.#....
#...#.....#....
#.##...#.#.#.#.
#..#.###.###..#
..###..#.##...#
.#.##......##.#
.......###....#
.##.#..#.#.####
###..##..##.#.#
##.#..#.#####.#
..#.##.##.##...
#..##.#.##..##.
##.#.#...#...#.