15 15 0
9 9
12 8
##..#.#..##....
#...#...#..#.#.
.......###....#
..#.#..##..#...
#..........#..#
.#.###...#.#.#.
#.............#
...#.####.##.#.
..#####..###...
#.##..........#
..#..#..#.##...
..##..#.#.#.###
#....###..#.##.
###.#.##.##....
###.....#.##.##