15 15 0
0 5
5 2
.#.##.#...#...#
..#.#...#..#..#
#.##..#.#.#####
#.##..##..##.##
.....#.#.....##
.#..#....##.#..
###..#.###...#.
##....#..###...
#......#.....##
##..#..##..##..
#.##..##.#..#.#
#####....#..###
.#.###.#.......
...........##.#
..#.....##.....