15 15 0
10 7
14 10
##.##.########.
.#..#.#.####.##
...#######.##..
.#.#.#####..###
#...###..#..##.
..####.#..#.#.#
#.###.###.###..
.#.#..####.#.#.
..###.#.##.#.##
..##.########.#
###.##....##.#.
#.#..###...####
#.#...#.#.#####
.########...#.#
#...###.#..#.##