15 15 0
8 10
6 11
.####.....#..##
...#.###...####
..##...#.##...#
....#.#.##...#.
##.#.#........#
#.....#..####..
........#...#..
..##.##...#.#.#
.#....#.....###
#.........#..##
#..#.....#..###
.....#..##.....
#.#...###.#.###
..###.....##.#.
###.######....#