15 15 0
10 12
12 11
....#....##..##
#.#...#......##
.........#.##..
....##..#.#.#..
.#...###..#....
..#.#.###.#..#.
#.....#.##..###
..#...##.....#.
#...#...##...##
...##.#.#.#####
####....####...
.#..#.#....###.
#...#.#.##.....
.####.#..#.#...
..##..#....###.