15 15 0
1 9
7 5
#...##.##.#.#.#
##.######.###.#
.#######....###
.#.##....#.#.#.
#.#.##...##...#
#.#....##....##
...##.##...#..#
.#......#######
.##...#....#...
.###....##.###.
##.....#.##.#..
...###.#..###..
..#.#...##.#.#.
.#.##.##..#####
#.#...#..#.#.##