15 15 0
0 5
12 0
#.......###..##
####...#..##.##
###.##.##..####
#...##.#...#.##
.##....##.#.#..
....##....#####
....#....##....
#.......##....#
..#......#.#...
..##..##.####..
.##..###..##.#.
.#.#.#...#..#..
.###..#........
#..#.##.#...##.
#....#.##.....#