15 15 0
7 7
9 4
..##..#..######
.######.#.###.#
..###...##.####
######..######.
.####...###..#.
..#.#.#####.#..
...##....#.##..
.###.#...###...
.###.##.#..#...
#.##....##.##.#
.#....#..#..##.
......#.#.##.#.
...##.#####...#
#..#...###..##.
#...#..#.#.##.#