15 15 0
10 8
2 5
.......##....#.
#......#.###.#.
..##..#.#....#.
#.##.#..###..#.
...####..####..
.#.......##..#.
...#......#.#..
...##.##..##.#.
.....#....##...
#.#......##.#..
.#....#..###.#.
.......##.##.#.
###.###..#.#.#.
#..#.#.......##
#...#..###..###