15 15 0
7 11
6 10
..##.#.###.##..
.###..#.#..##.#
#.##.##.##....#
.##.##.##....#.
##..######.####
##.###.#####...
.#.#....#..###.
.#..........###
...#.###...##.#
.##.#.#.####..#
.##.....####..#
##.##...#...#..
.####.#.#....#.
##.#.....####..
.##..###.##.#.#