15 15 0
5 5
3 7
#.#.#..####.###
....#.###.#..##
..#.....##..#.#
##.#.##.###..##
##.....##..##.#
##.##.#..#..#..
..###...#...###
.#.#...#.##....
#.#.#...##.#.##
...#.#..###...#
.###..###....#.
#..#.#..#.#.#..
.#...##.#.###..
###.#..#.###.##
#....######....