20 20 0
15 0
12 7
#..#####..##........
...##.###.##...#....
.#.##.##.#.#..#...##
.#.....#.##...#.#..#
#.##.#..#.#.##..##..
..........##.#.#.##.
####.##....#.##.....
...#..#.#........#.#
...#....####.#.##.#.
#####.#....##.#.##.#
####..#.#.#..#..###.
.....##...#..#...#..
#.##....#.#.#...#.#.
......###..#....##..
....#.##.#..##.#....
..#..#.#...##.#.....
.#..#####.##.#......
....######.##.#.....
.#.###.#.#....##.#.#
..#######.......#.#.