15 15 0
9 1
13 4
###.#######..##
#.#####..##.###
###########..##
#.##.#####..##.
..#.##.#...#..#
###..#..##.####
#.##...###..##.
.#...#.#.###.##
...#####.######
#.##.###....##.
...#.......#.##
##.###.##.####.
....#####.#.###
.....#..####.##
####..###.##..#