15 15 0
8 8
4 3
....##.#.##..#.
#..##..#......#
...##....##.##.
...##.#..####..
##......##.#...
.#.#....#.###..
#...#..#.#.#...
#..#.#..###..##
#.#.#.....#..#.
.#...###.#...#.
###..#.#....###
.##..##...#....
.#........#.##.
.####....#..###
..####....#.#.#