15 15 0
11 5
3 1
#.#......#.....
....##..#...###
..##...#..##.##
..#....#..#..##
#.#.#.###.....#
..#...#####...#
.##.#.##..#..#.
#..#..#.#....#.
#..#.#...#.###.
#.#.......##...
#.###.#.......#
#...#.#.......#
#..#....###.###
.#...#....#.#..
##.#....#......