15 15 0
5 2
6 5
.#....#.....##.
......#......#.
....#...###....
..##...#.##....
.....#.#.....#.
#......###...#.
....#..#.##.###
##.#...#.##....
#.#.#.#...##.#.
..#######..#..#
.##..#.###.#..#
..###.#..##..#.
#.#.#..###.#...
..#####.....#..
..#..###.#...#.