15 15 0
9 10
1 13
###.##.#.#....#
#....#.#..#...#
.#..#.#.##..##.
......##...#...
..#...##.#.#.##
...##.....##..#
..##.####...#..
..#..##.#..#.#.
#...#.......#.#
##..#.#.#..##..
..####.....###.
.....#..#.#.#..
###..#.##.#..#.
#.....##..##...
##...##.......#