15 15 0
3 5
8 10
.#........#....
.#.##...#.#....
#...##.##......
.#..#..###....#
.#....###.#####
...#.....####..
.##...#..####.#
####.#...#.....
#.#..#.#......#
#..#..###..###.
#...#..#...##..
...#..#..##....
.....#..#.#####
.#...#.....##..
.#....###......