15 15 0
1 14
1 7
##.#..#...##.##
.####...##.#.#.
#.####.#####...
#.#..#.##.##.#.
###..........#.
.###...###.###.
##.....#.###.##
###.#...#######
###.####...##..
##.###.###.####
#.##.#.##..####
.##...######...
##.#######.##.#
##.#.##.####.##
####.#..#.###..