15 15 0
13 4
7 4
#.#.##..#.##..#
.#..###....#..#
....#..#.#..##.
#.#..#...#.#...
#.###..##..##..
#..#.....####..
.#.####..#..#.#
.#...##.##..#..
.#....##....#..
..#.#.#.#..##.#
#.#....##.####.
.##.#.#.....#..
##.#...#....###
.###.#.#.#..#..
.#.#.#...###..#