15 15 0
8 3
13 11
....#.###.#....
..##...##...##.
..##.#..#.....#
..#......###...
.#.#........#..
...###..#.#..#.
###.#..##...##.
##.##...##.##..
.##..###.......
..##.#....#.#..
#......#.#.....
..#.#.#.##.##..
##.......#.....
.#..#...#.#...#
...#.#........#