15 15 0
1 6
3 6
#..##.#.....#..
#...#..#..##.#.
#.........#..#.
.#......#.#.###
.###........##.
.#..#...#.###..
..#...#.#.#.##.
##..#....##..##
...#..#........
#.#.#...#..###.
.###..#..#.####
..##.....######
.#######..#....
.####.....#.#.#
.....#.##.##...