15 15 0
4 5
8 11
.#.#.......#.#.
.....#.#.......
........##.#...
###..#.#..##..#
.#..#...#...#..
#.#.##...##...#
.###..###..##..
......#..#.....
##.#....#.#..#.
......##.#..#.#
.###...#......#
#.#.#.##.####..
........####..#
#...#.#.#..#.##
.#..####.#.....