15 15 0
11 13
10 14
#######...###..
###.#.##.####.#
.####..#.#####.
#...####.#.#...
....###########
#.##..##...##.#
#.#####.####..#
###.###...#..##
.###.#####.##.#
######...###..#
..####.#.#.##..
###.#.###.#.#..
#..##.##.###.##
.#..#####.#.##.
###.##.#.####..