15 15 0
13 7
12 13
....##..#.#.#.#
##..###.##.#.#.
#..#.#.######.#
...#.#.##..#.#.
...##.#.#...#.#
..#..#.###.##..
#......#.#.#.##
##.....##..#...
####.#......#..
#..###.#..#..#.
#..###..###.###
..###..#.###..#
##..#..##..#...
#..####..#...#.
#######....#.#.