15 15 0
0 12
0 14
##....###.##...
.########....##
#.###########.#
#.####.#######.
.....#..###....
.####.#.##....#
#####.##..#####
.##...##..####.
.#.#.##.###.#.#
#.##..##.#.###.
##.##.##.###.##
..#.#...#..#.#.
#.#..#.##..#.#.
#.#.#.#.###.##.
.##....###.##.#