15 15 0
9 8
9 1
###....###..#..
###.#..#.#.....
#.##.#.####...#
#.###....#...##
##.#......###..
..##........###
.#...##.#...#.#
.##..#....##...
##...#..##..##.
#...#.#...##...
.#.....##...##.
#..#......#####
..#.####..#..#.
#......##......
..#.##..#..##..