15 15 0
9 10
4 5
##..#.#.#.#..##
..##..#.#####..
#.#..##..###...
####...##.####.
.##.#.###.#####
#..#..##..#..##
..##.###..#.###
###....#....#..
#####..#####...
##.#..###..#..#
...#......###.#
...#.#####.####
..#.#.##.#..#.#
..######.##..#.
.....##.#.#####