15 15 0
1 8
9 4
....#.##.##.##.
.######..##...#
###..#.#...#...
..##.#.#.#.....
....###..##.#..
#.##.##....#..#
.#.######......
.#..#..#.......
###...#.#...#..
##.#......##.#.
....##.##.##.##
.#..#.##.###..#
.#.#..###.#..##
##..####.....#.
####.#.####...#