15 15 0
8 6
10 6
##.#.######.#..
##.##.....#.#.#
.#####....####.
#....####.#.##.
##.######..#...
###.####.#.#.##
##..#..#....###
##.##...#.#..#.
.##.##.........
#...##.###...#.
..####....#.##.
..#.#.###.#..##
##.#..#...##.##
#.####.##.##..#
.#..#.#.#.###.#