15 15 0
8 7
1 8
.....##..###.##
#.##..#...#...#
...####....#.#.
..#..##....#...
..#.#.....#.###
#..#......#.#..
..#.#.#..#.#..#
##...#..##.#...
##..###.##.#.##
#..#..###...##.
#...####......#
#......#..###..
#.#..##.##.#...
...#......#..#.
...#.#.#..##.#.