20 20 5
5 2
7 1
..#.######....#####.
##.####..####.###.##
###..###.#....###.##
.#.##.##..########..
###.###.######..#.#.
...#..#.#####.###..#
#....######.########
#..#.##############.
..#...####..###.##..
##.#####...##.#####.
#####.###.####.###.#
.####..##.#..#.#####
.#....#...##..#.#..#
.##...##.#.#####.###
.###..###.##.#.##.##
#.###.#.###.########
#############.###.#.
#....##.#####..#.#..
#..#......##.###.###
#####.##.#######.###
