20 20 5
7 15
10 12
###...###.....######
....##.#.#..#.#.#.##
#.#########.#####.##
#######.#..###..###.
.####..#.....##.#.##
######....##.#.##...
.#.###.#........##.#
#..#.###.#.#..#.#.#.
####.####.#..####.##
#..##.###.##.##..#.#
.#..##...#...#..##.#
#..####.###.##...#..
#..###.#.###....####
###.#..###..####..##
.#....##...#..#.####
#######.#...##.###..
#.#..######..######.
.####.#.#######.####
###.###..#.#####.###
#..#.##.####...##...
