20 20 5
8 5
9 0
..####.#.####.###.#.
#.###.##.#...###.###
##.####.###.###..#..
..#.#..#..###.#.##..
####.#...######.##.#
##.....#.###.#..##.#
#.##.#.....###.###.#
#.#.######..##.#####
.##.#.####..####.###
.#.#...#.##.#.#.#.##
..##.#..###...#.#..#
.#....#....##.##.###
..#.#.#.##.#.##.###.
....#.#..#.#..###.##
######..#######.####
.#.#..##..#.#####.##
..###..##.##.####..#
#.#..##.#.##..#.#.#.
.##.#.##..#...######
.###.###.###..####..
