20 20 5
10 3
13 4
....##..##.#.#.....#
###.##....#.#.#.....
#......#...#..######
##...##...#.#.#.###.
##..##.........##.##
.#####..###...##...#
.##.##......###..###
..#..#.#..#.......##
#.......#....##.##.#
..##..###.#..#.....#
.##.#...##....#.#...
##.....#..#.#..##..#
.##.....#.##..###.#.
.#.#.##.#.#.###.##..
.#...#.....#...###..
#.#.......##.....#..
.#..#.......###.##.#
...##.##...##..#.##.
##.#...#.####.#.#..#
##.###..#.##..###.##
