20 20 5
9 17
11 18
.###....########.###
####..#..#########.#
##.#########.#..###.
.#.###..##..##.#.#.#
..#.#####.##.####..#
.#.########.###.#.#.
.###.##.###...#..###
##.###....##....#.##
.##...##..#.##.##.##
.###..####..#.##..##
#......#.##..###....
######..#.#..##.##..
##..##.#..#..###....
.##.#..######.###.#.
#....###.#...###...#
.#...#..##.##...####
###.#..####.##....##
##.#.####....####..#
#..##..#...######..#
####..#.##.###.#####
