20 20 5
11 3
9 8
#.#..#.#.#.#.##..#..
####..#.....##..#...
###.....#..#.##..#..
..#...#......#...##.
....##...#..#...##..
....#.#.#....##.###.
.#.##.##.##.##...#..
..........####...#..
#..###.....##.###...
###....#....#.##.##.
####.##.##..#.#...##
.#...#####.#.#.#..#.
#....#.###...#..###.
##..##..###...####.#
#...#.....#.......#.
##....#.####.##.#...
#..##.#...######.##.
..#..##...##...####.
.####..#.###...#.###
.....#........###...
