20 20 5
6 7
8 15
..#...#.....###...##
##..####.###...##...
....#..##...#.#####.
..########..#.....#.
#.###..#...#....#..#
..#.#.#.#....###....
..##................
.###.......##...#...
..##..#..#..#.#.##.#
..#.#.#.#..###......
.#.#....#...#....##.
#...#...#.##..#.#...
#..#.#..#.#.##.####.
.#..#...####.##..#..
#.##.#.#..#.#..#....
.#####..#.#.#..#..#.
#...#.#####..#..###.
#.##..##..##...#.#..
##..#.##......#.....
.#.#.#.#......#.....
