20 20 5
16 18
1 15
.....#..##.#.....##.
.#.....#.#..#...#.##
.#.#.#..#.#.#.......
##.######..#.##.#..#
....#.#.#..........#
#..#.##.....##.#.##.
#####.#...#..#.#.###
..#.###..#......#..#
...#..#..#....#.##.#
#..####..###.#.#...#
.###...##.#..#....##
...#.####...#....#..
.#.#...##...##.#..##
.#.#.....#..#..##.#.
#...#.........#.#.#.
.#....##......##..##
..#.......#.##...#..
#..#.#.#.###..##....
#.##...#.#....#....#
.##.....##.#.####...
