20 20 5
5 9
9 10
#.#...#.##....#....#
..#.#..#.###..#....#
#.#...##..##...###..
#..#.##..#.##...#..#
........####.##.#.#.
....#.#...##.#.#...#
.#....#..#.#...###.#
..##.#..#..#..###..#
.##..#...###.#..#.##
.##...##......##.#.#
.#....##...##.#...##
.###..##.#....#####.
............#..##.#.
.#.#..#.#.##..###.#.
..##........#...#.##
...##..#..#...#...##
.#.#........#.#....#
##...#.##.##.#.##..#
...###.#..#..#......
.......#...#....#...
