20 20 5
14 6
10 1
#..#..#.###.........
..##.###..##..##.#..
#.#.#.####.#.....#..
#####....##.##.#....
#....#..#.###.##..#.
.#...#.#..##...##.#.
##..###.#.....#.#.##
##.####..#..#...####
#..#.#.....##...#...
.###...###.###..#...
..#.#...#..#..#..#..
#..##.#.##..####...#
....##.#.#.#.#.#.#..
##...#.##...#..##...
#.#.....###..#.###..
#.##....#.#.##..###.
##......#####.....##
####.......##...#.##
......#...#######.#.
.#.##.......####.#..
