20 20 5
10 13
10 16
.#.#.###..#....####.
##.###.####...##...#
##.#.#...#.#.#####.#
#####..#.#####.#.##.
##.....##....#..##..
#...######.#..###.##
..#.#...#.###..#####
...#.#.....#..##..##
.#..#.#...#####...##
....##.######...###.
#..###...####....##.
..#.##.#####.#.#.###
.#...###..####.##...
###.###....#....###.
..#.##.#.#.###..####
..#..###..##.###..##
...#.##.#...#.#..#.#
###...###...##....##
....##..##..#.##....
#.#.#.##....#####...
