20 20 5
10 3
17 0
.##.###..#.#.###....
#...#.#..#.#.#..####
.#.#..#####...#..#..
#......#.#....#.....
....#...#...#####..#
....###.##..#.##.##.
##..##.####......##.
....###.##..#..##..#
#.#........#....##..
###.#.##.#...#.....#
.##..##..##.#...##.#
......##..#..####.#.
#.#....#..#.#......#
#..#...##..#...####.
#.###.#....#...#.##.
..###..#.#...#.###..
...#...##.##.#.#.###
.....#...##...#.####
.#.#........##.#####
#..##..##.#...#..#..
