20 20 5
6 6
11 11
.###.#.#..##.#..#.#.
#.#.###....#.#....#.
#.#..#....#..####.#.
..#..#.###.#.##.#.##
....#.##...#...##..#
.######...#..###.#.#
###.##...#.#..#.##..
##.##..#..##....##..
##..####.#.########.
#.#.#.##..#...#..###
.###.#.#..#...#..###
..##.###.#..###.###.
...#.##....####.#.##
..#.#..##....##.#.##
.#.#..##.####.##.#.#
.##....##...###.###.
..#.#####.######.##.
#######.#######..###
.#.##......####.#..#
.#.###..#####.#####.
