20 20 5
13 11
4 8
...#...##....#..###.
#...#.##........###.
###.#..#..#..##.....
.#.#.##..#.#.....##.
#....###.##.....##..
..#..........#...#..
..##.#.#..###..#....
#.####.##...##..#.#.
#.#..##.#.##......##
#.#.#.##...##.###.##
...#..##...#.#.###.#
.#.#.#.##..#.#..#..#
..##.#.##...#.#.#...
###...#####..#..##..
.#....#.........#.#.
.#....#...##.#.###.#
...#..####.###.#..##
#....##.#.##..#####.
..#.####.#..#..##...
.#.##.##.##.....##..
