20 20 5
11 8
2 16
....#..##.#....#..##
..#.#.#..##.#...#.##
##.#..#.....#..#....
....#......###..#...
###.#....#...##.....
#.##......#.#.##.###
.#.####...##.##.###.
.##...##...##....#..
.#..#..##..#...#....
..#....##.##...#####
#.##..#...#.#..#..#.
..#......##.#..#...#
...###....##.##.....
.#.#.....#.##...#..#
#.#.#.#....#..###.##
..####.#.#....##.##.
.....##.###........#
#.#.##..#.......#..#
##..#..#.....#....##
.#..##..##..#..##..#
