20 20 5
10 13
19 10
##..#.#..#.#####.###
.#...#.#......#...#.
.####.#..####...##.#
#...##..##......#..#
#.#.#.#.##....#.##.#
..##...####...#.##..
...#...##.###....#..
#..##.#....#..###..#
##.###...#..#.#...#.
..##.#.##..#.#...###
#.##......#.#.......
######.#.#....###.#.
....##.....#..#..#..
...#....##...#.#.##.
..##......##.#.#....
##....#.#.#.#...##..
#####..##..#.##..#..
##.....###..##.#.#.#
.##..##.....#....#..
...#.#.##..##....#.#
