20 20 5
3 11
6 3
.#.#..#..#...##.#...
..#.##.##......#.##.
.##...##..##....##..
....#.#.#......##.##
.##....#..#...#.#...
.##.......#..#.#####
....##..#..####.#..#
....##.##...#.#..#..
#....##..#..####...#
....##..#.##..#.#.#.
###.#.#..#.#....#.#.
#.##.#.......######.
.##.#.##...#..###.##
#...##..#.##..#.....
#.####.##.#.###.....
##.##..##.#.#..#....
#..##.#...###...#.#.
#..##..#......####.#
.#.#.##..#...#......
#.##.#...#...#.#..#.
