20 20 5
9 17
5 7
#.##....##...#..#.#.
.###....##....#.##.#
.#.####..#..#.#....#
#..#.#...##.###.###.
#.#.####....#.###...
.##..#...##.##.###.#
#####.#.#.#...#.##.#
##.####.##..#.....##
#....##.#...###.#..#
####..#.....#...#...
.#.##.#########.#..#
..#.#.....####.#..#.
..####...#..#...#.#.
###..##.#.##....###.
##.#.#.....#..#...#.
#.#..#.######..##.##
#.#..##.....#.####..
...#.#####..#.#...#.
.#....##...###.#.##.
#.#.##..#..#...#.#..
