20 20 5
0 5
0 10
#.###...#...###.####
.##.#.#...#.....#.#.
.#...###.#.#.###.###
#.##.##....####...##
......#...#...#....#
.#...####.##.##..#.#
#....#.##.##.##.#..#
####..##...##.###.##
#.##.###.###...#..#.
..#######.#.##.#...#
#..#..#.#..##.##..#.
#.#.#..#..######.#.#
...###..#.#...######
..#...######.###...#
.#####.#.##.#.#.##.#
###.....#.#.#..###.#
####..##.###.##.....
.#..#.##.###.#..##..
#.#..#.####.###.##..
.#########.#####.#..
