20 20 5
17 10
10 8
.#..##...##.#####.#.
#.#..#.###..#...#..#
..##...#...###......
#.#.#.#......####...
#.....#...#....#....
.##.##...#..#.#####.
#.#..#.#.#.#..#.##..
.#...#.#.##.#.#.#.#.
.#..###..#...#..#..#
..#.##...#...#####..
#.........#..#.#...#
....##..########.##.
.#..#..#...#...###.#
.....#...#..###.###.
.#....##..#........#
##.#.#..#..#.#..###.
.####.#...##.....###
..####........##..#.
..#..#..#.###.#.#..#
.####..#..###..#.##.
