20 20 5
7 13
11 16
##.#.####..#.###..#.
##.#.#.###..#####.#.
##....##...#.......#
#####...###.#..#.#.#
####......##..####.#
##.###.#.##..#.###.#
.#..###.##.####.####
....#.....###..#####
..#.######.#.#......
###.####..#.#.###.#.
##..####.#..##....##
#.###.########....#.
#....###.####.####.#
.####..##..##.#####.
..##.#..###.#.#.#.##
##..#....#.##.#.###.
......##....##.....#
.#.###..#...###.####
##.#.##...#.#...#...
.##.###.....#...###.
