20 20 5
9 5
7 7
.###...#...#..#.###.
..##.....##..#.##.##
#.#...#####.#..#..##
....#..##..#..#.####
...#..##.###.#.####.
###..#.##..##....#..
#...###...########..
.##..#...##.#..#....
.###.#...#....##.#..
..#....##.######..#.
.###.....###......#.
.#....###.##..#....#
.###.##.......#.##.#
##...#....#..#.##...
.####.#...#..#...##.
####...##....#...##.
.##.#.#.#########.##
#...#.#....########.
..##..#.##...#......
.#...#....#..###..##
