20 20 5
12 5
15 4
#######..##.##.#..#.
#..#.##..##...##....
.#....####.#.#..#.#.
.....##...#...#....#
##.....#..#....#...#
..#.##..#.#.##.#.###
.##.##.#....#.#.##..
...##...###.#.#.....
.##...###......#...#
###.##.##.#.###..#..
...#....#....#..##..
##..#.#....#.##..#..
##.#...#..#...##..#.
...#...##.##..#....#
#....#..#.....###.#.
...#..#.##.#.#..#..#
#..............#.#..
......#....#.###.##.
...#.##..#...#...##.
.##.#....##..#....#.
