20 20 5
12 2
6 0
.....#...##.#...#...
.#.........#.#......
..##..##.###.#.####.
..#.#.......#..###..
##..#...#..###......
..##..#.#.###.#..#.#
..#..#.#...#...##.##
.###.##.#...#.####..
..#...#.##..##...#.#
.#...##.#...#.......
....###...#...#...#.
....#.#......#....#.
...###.###.###...#.#
#.#...#.#.......#..#
.##...#..#.###..###.
.#..#..#.##.###...##
##...#.#...#######.#
#..........##..#.#.#
###.#.##..#.........
#..#.#..##...##..#.#
