20 20 5
11 14
8 6
###.###.##.####.##.#
.###.#...######..##.
.####..###.#.#..##.#
.##.##.####.#.#.####
.##.#.##.##.##...#.#
#...#..##.#.#####...
...###..#.....##....
##.#.#.#...###.##..#
#.#.#....#######..##
#..#...#......##..##
####.##.......##.###
###.#.##.####..#....
.#.#.........#..##.#
######..##.#..####..
.##.###.#...#####.#.
.#...###..#.####....
...##.#...##.#.###..
#..######.....##.##.
.###.#####.#.###.#.#
.#.#######.....#....
