20 20 5
6 17
7 9
..#...#.####.###...#
##....#.##.##.....#.
#...##.....#..###.#.
.....##.#.....#.....
...#.#...#...#.#..#.
...#...##..#..##....
.#..#...........#...
...#.##...#...#..##.
#.#....#.#.##.####.#
..###.#.#..###..#.##
.#.#.....##...#.....
##.###..####...####.
###..#.#...#...#.###
###.#..####.#...#...
#...#.##..#.##.#.#..
##....#.#.#......#..
#..###..#....###....
.#..#.#.######......
#..#.####...##.##..#
.#.......#..#####..#
