20 20 5
17 12
7 18
#..###...##....#.###
.#...##..#.#.###..##
#...#..#..####....#.
..#..#.#.#####.#.#..
.#..##.......##..##.
...#..#..##....##...
###......#..#.##....
#####.#..#.###.....#
#...#........#...#..
#####..#.....##.#.##
#.##....#.###...#..#
.#..#.....#..#.#..#.
.#.##.##....#..#..#.
......#....##.#...##
...##.#..####..##...
.##..#...##...#...#.
#..###.##.##.#.....#
####.#.###.#..#.....
#.......#.#..#.#.##.
#####.###.#...##.#..
