25 25 5
6 9
2 10
.###.###.#...#..#..#.....
..#..#####.##.##.#.#.###.
.#...#.#...#.#...#....##.
#.###....#.##.#.....##.#.
........#.#.###...#.#.###
..#.....#......##....#.##
.#.#......##.####.....###
.##.###...#.##....##..#..
#.#...#..##..##...#.##...
##.#....##.#.....###..##.
.##.###.#....##.#.....#..
#...#.##...#.##..#.#####.
.....###...#.....##.#.#.#
....##...#..#.#..########
####.........####..#...##
.##.##.###..#......#....#
.#...##..#.##.#...####...
...###.#.#....#.#####....
....##.....#..#..####..##
.#..#........#.###..##.##
.####..##....#..#..###..#
#.#....#...#..##..#..#.##
.###..#...#####..#.#..#..
##.####..##...#.###.....#
#...#.##..###...#####.#..
