20 20 5
14 3
12 5
#.##...##...#..##.#.
.##..####.#.#.#.#..#
...#..#.....#....###
#.#....####...#..#..
##..#....#.########.
...####.#....###.#..
...##..##.###.....#.
.#..###...#..#.#..##
.#..##.#.#.#.#...##.
.#..##...#..#..##...
.#..##.#.........###
.###.#.##.##...#...#
..#.....#......##.#.
#.#.##..#..##...#.#.
.#..#.##.##.....#..#
###..#######.#....##
.#..#.##.#.##.##....
.##.....#......##.##
#.##..#...####.##...
...#....#..#.....#..
