20 20 5
13 0
11 1
#.#......#.#########
.##.#............#..
###...#...#.......#.
#....##...#......##.
###....#.#..#..#....
..##..#.##...#.##...
....######..#.....#.
.....##.###.#.....##
#.##.#.#.#...#....##
.##.#.##.#.####.....
..#..##.....#...#...
#.##...#.#.##.....#.
#...#...#.#......###
...##.#...##.#.##.#.
.....#.#.#.......#..
#.##...#.##.....##..
...#...#....###..##.
####..#..#...#...#..
#..#..##...##.#.##.#
..#..###...###..##..
