20 20 5
18 18
16 14
.#..........#..#...#
#...##.##.#..#.##.##
######...#..#.....#.
...#...#...#.##.#..#
##...#.##.######.#.#
.#.#####.#.###..###.
##.#......#.##.#.###
.#..#####.#.##.##...
...#......#..#......
...#.#..###..#.#.#..
###.#...###.##.####.
..#..####.#...######
#...#.#...#...#.####
..#....####..##...##
.##...####.#.#..###.
..###..#.#...#...#.#
###..#.#...#.#.#...#
#.####.#.##..#.###..
#.###.#######.#.##.#
.#....##..#.#..###..
