20 20 5
11 4
12 5
########.##.#..#..#.
#...#..#.#.##.#.#...
..##....##...####...
#.#.##...#...###.#..
.##..#...#.#.##...#.
#..#....###.#......#
#.#....#.....#...##.
#...#.#.#.#.###.#.##
#.##.#.#...###..##..
##..#.#..#...###...#
.#...#.#.###..##....
...#....##..........
.##...#....#.#....#.
...#.###..#.####.##.
#...##....#.####.#.#
##.####....##...#.##
#...##.##.....####.#
...#.#..##...#..####
...#.####.#.......##
..########.###.....#
