20 20 5
11 15
14 19
.#........###...#..#
...#.###...##..#.#.#
..#...#.....#..###.#
#..###...####.....##
...####.######......
.#..#.##........#...
......#...##.#.#.###
##.##..#####.#..##.#
.##.....#...#####..#
....##.#.#....##....
##.....##....#.#.#..
...#...####..#......
##....#.......#.##.#
......###........#..
.....##.##.##...##..
#.....##..#........#
.#...##.##.##......#
..###..#...######...
#.#.#.#...#..#......
.....#.#...#....###.
