20 20 5
18 16
18 14
..#.#..##..##.##.###
####.##########..#..
####.#######.#####..
######..#.#.##.#...#
###.#..##..##.######
..#######.#######..#
..###.#.##.#.#####.#
###.###.########..#.
####...##..##.#..###
########.####.####.#
#.####..##.#.##..#.#
#..######.#.##.##.#.
###.###.##.#.#..####
###########.##..#.##
.##.####.##.#.#.###.
.#..##.###########.#
#.###.###...#..###..
#.#.####.##.#.#.####
#####..###..##...#.#
.#..##.#######...##.
