20 20 5
17 15
14 2
.#......#.#...#.....
.#....##....#..#...#
##.###.###.#...##.##
#..#..#.##.......##.
#....#....#..##.#...
.#.#...#....#..#.#..
....#.#...#..#.#...#
#..##....#.#..##.#..
###.#...#.........##
....#..##...#.#....#
#..##......##.#.#...
.#.#..#..#..##...###
#....#...####..#.#.#
.##.###.#.#..#..#...
....#.###...#.....##
.#.........##..#....
.###...#..####...#..
.#....#.....#...#...
.##....###..#.#.#...
###...#...#..#.....#
