20 20 5
16 9
8 11
.#.#....##.#..#.....
#....##..#####...#.#
...#....####.#..#..#
#####..#.#.#...#...#
......####...#....##
#..##.##....#####..#
.#.##.###......##...
.###.######...##.#..
.#....####...###.##.
##....##...........#
#...#...##.#..#..##.
#...##..#..#.#..#..#
#....##.#..##..#..##
.#.##..#..#..##..###
####.###.#.##.#.#.#.
.#.##....#...##.....
#.#.####..##.#..##..
#...#.......##....#.
..##..#....#..##...#
#.#.##.#............
