20 20 5
12 0
11 2
#.#.#..#....#..#..#.
#.##.#####....#...#.
.......#.......#...#
#.####...#..#..#....
#.#.....#..#.###.###
.##......#.####....#
#...###.##.#.#..#...
..###.....#....#.##.
#.####.#..#..#..###.
###..#.#.###.#..#.##
.#.#.#.#..........#.
....#.#.#######...##
..##.......#.#.....#
###.##.######.###.#.
#...#..#...###..#.##
#...##.######..#####
.####...###..#....#.
#..#...####.#.##...#
...#.....#.#.#..####
...###..####.###..##
