20 20 5
14 14
19 9
..##.##..#.#........
.#....###.###..#...#
..#........#####....
#..##...#.#....##.##
...##..#.##..#.#..#.
..#.####...#...#.##.
.......#.###........
..###..##......###.#
..###.#.##..#.##..##
##..#.#.....##....#.
.#.#....#...##..#..#
..####..##..##..#.##
#....###.....#.#.#.#
#.###.#..##.###..##.
..##...#........#.#.
.#.##..#...#.####..#
.#.#....##.#...#..##
.##....#.........##.
#.#...##...##.###..#
.##..##....####...#.
