10 10 5
6 1
5 2
###....#..
.##.##....
###.##.#..
.#.##.####
..#..####.
.#.###.##.
...#......
#...#.###.
..#.#.#.##
..###..###
