20 20 5
6 1
8 8
....##.#.....##.....
.###......#..#.#####
..#####...##.##...##
...#..####.#.###..#.
##......#..##...#.#.
#...#.###..#..#.##..
..##......#####...#.
.......##....#....#.
..#..#.#..#...#.##.#
##.#...##.#.#...#.#.
.#............#....#
#.##...###.##..#..#.
##.#..##....##...#.#
..#..###.#.##....#..
.####..#...#.#.#.#..
...###...##...#..##.
...##...##....#.....
######........#..#..
##......##.#..#.##..
.#..##....##..##....
