20 20 5
14 5
10 17
..#.####..#..#....##
....#.#..#.###.#####
.##.....##.#..#....#
##..#...#........##.
......#.#..##.##.##.
.###...#..#.#......#
...######.....##.##.
..........###..##.##
..#..#.##..#.##..#..
....##..##.#.#..#...
#.#####.....##....##
....###.#..#.#.....#
..##...#....#....#..
.....#.#.....##.#...
...##..#.#..##...##.
...#....#......#.###
.##..#.####.#.###..#
###...#..##.#..#..#.
#...#........#.#.##.
...#.#...#.#.....###
