20 20 5
14 0
15 0
.#...#..##.##.......
##.###...###....###.
..#.#..#...#..#.#.#.
##.###...#..####.#..
...###...#..#.#.##.#
#..#.#...####......#
....#.....#.#.##...#
......#...#...#.#...
...####........#.##.
##...#...#..##.##.#.
.#.#....####.##.....
..#.#.#.####......##
#......#.##.#..#....
#####.#.#.##....####
...#.##.....##...#.#
.##...#.###.###.....
.####.#..###..##.#.#
.#....#...#.......##
##....#..##.##.###.#
#.##.##.##..##..##..
