20 20 5
12 6
12 2
..####.#.#.....#..##
...###...##..#.#..#.
###.####.#.........#
.##.#........###.#.#
###....#...##..#....
#.#..#.#.##.#.#.....
.##..#....#.##.####.
......#..###.###.###
.####.###.....#...#.
...##.###.....######
...#...........#.#..
......#.....#.#.....
##..#...#...#####.#.
#..#.#.#..####.##...
#.###..#...#.#######
..#.##.#.##...###...
######.......#..#.##
...#...##..........#
#..##.###....#.##...
#####.#..##.....#.##
