20 20 5
11 8
19 11
###...#########...##
#...#.######......##
##......#....#.#..#.
##.###......#..##..#
#.....#.#.#.#.####.#
.#...#.#.....#.#...#
.#...######...#.....
....##..#..####.#.#.
.#..##.#..##..#.####
.##.##...#..#..#..#.
#..##...#.###..##..#
.#....#....#..#..#.#
..###.###...##..##.#
..#.###.###..#.#...#
#.#....#.#.#.#.##.#.
.#.......#....#.##..
..#...##...#......#.
##......#....#..#...
.#..#...###.#.#.#...
.#.#..#.#...#...##..
