20 20 5
12 3
3 7
.##...#..#...#.##...
#######.#...###.....
#.##....#...#.#.#.##
...#.#..#........#..
.#.#....#...###..###
..........##.......#
.##.#.##..##......#.
...#.#.#..#....##...
.#...#..#.##.##...#.
....#.#.#.#..##.###.
...##....#.#..##..#.
......###.#......#..
....#..#...##.##..#.
##.#.##..#..##..#..#
##..#.......###..#..
.##...##.####...#..#
#..#.#..##...#.##.##
#.####....#.......#.
...##.##...##.....##
...###....#......###
