20 20 5
18 7
17 7
#..#####..###.##..#.
#....##.#...#####..#
.....#..#.#.##.##..#
#.#..##...#...#.....
..########..##.#.##.
..#.....#.##.#.#.#..
#..##.#.#...####..#.
##...#.##.##.###....
####.#..#.###.#....#
##..#...#..#.#.#.#.#
.....#..##.#.##..##.
....#.##.#.########.
..#..#...##.###...##
#..##.#..###...####.
..#...#.##.#...#...#
.##.###.....##...##.
.#..#..#..##....####
..####...#.#.....#..
...#..#.######.###.#
###.#.....###..#####
